abandonner 	abandonner 
abondante 	abondante 
abord 	abord
aborder 	abord
abordÃ 	abord
abouti 	abouti
aboutir 	abouti
aboutissement 	abouti
abrite 	abrite
abritera 	abrite
absence 	absence 
absorber 	absor
absorption 	absor
abstress 	abstress 
academy 	acad
acadÃ 	acad
accent 	accent 
acceptabilitÃ 	acceptab
acceptable 	acceptab
acceptÃ 	accept
accessible 	accessible
accessibles 	accessible
accompagnant 	accompagn
accompagne 	accompagn
accompagnement 	accompagn
accompagnent 	accompagn
accompagner 	accompagn
accompagnons 	accompagn
accompagnÃ 	accompagn
accord 	accord
accords 	accord
accrocher 	accrocher 
accroissement 	accroissement 
accroÃ 	accroÃ 
accru 	accru 
accrue 	accrue 
accueil 	accueil
accueillera 	accueil
accueilli 	accueil
accueillie 	accueil
accueillir 	accueil
accÃ 	accÃ 
achat 	achat 
acheter 	acheter 
achever 	achever 
achevÃ 	achevÃ 
achÃ 	achÃ 
acides 	acid
aciditÃ 	acid
acoustique 	acoustique
acoustiques 	acoustique
acquis 	acquis
acquise 	acquis
acquises 	acquis
acquisition 	acquis
acquÃ 	acqu
acte 	acte 
actes 	actes 
acteur 	acteur
acteurs 	acteur
actif 	actif 
actifs 	actifs 
action 	action
actionnaires 	action
actions 	action
activation 	activation 
active 	active 
activement 	activement 
actives 	actives 
activitÃ 	activitÃ 
actuel 	actuel
actuelle 	actuelle
actuellement 	actuelle
actuelles 	actuelle
actuels 	actuel
adaptation 	adapt
adaptative 	adapt
adaptent 	adapt
adapter 	adapt
adaptÃ 	adapt
additifs 	additifs 
ademe 	ademe 
adhÃ 	adhÃ 
adjoint 	adjoint 
administration 	administrati
administratives 	administrati
admirer 	admi
adoptent 	adoptent 
adresse 	adresse 
adultes 	adultes 
affaire 	affaire
affaires 	affaire
affectant 	affect
affectent 	affect
affective 	affect
affectÃ 	affect
afficher 	affich
affichÃ 	affich
affilÃ 	affilÃ 
affirme 	affirme 
affranchir 	affranchir 
afin 	afin 
agence 	agence
agences 	agence
agent 	agen
agents 	agen
agir 	agir 
agira 	agira 
agissait 	agiss
agisse 	agiss
agissent 	agiss
agricole 	agricole
agricoles 	agricole
agriculture 	agric
agroalimentaire 	agroalimentaire 
agronov 	agronov 
agroparis 	agroparis 
agrosup 	agrosup 
agroÃ 	agroÃ 
ai 	ai 
aide 	aide
aider 	aide
aides 	aide
aient 	aient 
aisÃ 	aisÃ 
ait 	ait 
aix 	aix 
ajoute 	ajout
ajouter 	ajout
ajoutons 	ajout
ajoutÃ 	ajout
alarme 	alarme 
alerte 	alerte 
algorithmes 	algorithmes 
aliment 	aliment
alimentaire 	aliment
alimentaires 	aliment
alimentation 	aliment
alimente 	aliment
alimenter 	aliment
alimentÃ 	aliment
allait 	allait 
allant 	allant 
allemagne 	allema
allemand 	allemand
allemandes 	allemand
aller 	aller 
allergies 	allergies 
allez 	allez 
alliages 	alliages 
alliance 	alliance 
allier 	allier 
allions 	allions 
allongement 	allon
allons 	allon
allÃ 	allÃ 
alors 	alors 
alpes 	alpes 
alpin 	alpin
alpine 	alpin
alternatives 	alternatives 
altimÃ 	altimÃ 
altÃ 	altÃ 
alzheimer 	alzheimer 
alÃ 	alÃ 
ambiance 	ambi
ambitieux 	ambiti
ambition 	ambition
ambitionne 	ambition
ambitions 	ambition
amenÃ 	amenÃ 
america 	america
american 	america
amont 	amont 
amorÃ 	amorÃ 
amphis 	amphis 
ampleur 	ampleur 
amplification 	amplifi
amplifier 	amplifi
amÃ 	amÃ 
an 	an 
analogues 	anal
analyse 	analyse
analyser 	analyse
analyses 	analyse
analytique 	anal
ancienne 	ancienne
anciennes 	ancienne
anciens 	ancien
and 	and 
angers 	angers 
anglais 	anglais 
angleterre 	angleterre 
animale 	anim
animations 	anim
animaux 	anim
animer 	anim
animÃ 	anim
annonce 	annonc
annoncer 	annonc
annoncÃ 	annonc
annuel 	annuel
annuelle 	annuel
anomalies 	anomalies 
anonymes 	anonymes 
anormale 	anormale 
anr 	anr 
anthropiques 	anthropiques 
anticipation 	anticip
anticiper 	anticip
antilles 	antilles 
antipolis 	antipolis 
antoine 	antoine 
aoÃ 	aoÃ 
ap 	ap 
aperÃ 	aperÃ 
apparaissait 	appar
apparaissent 	appar
apparaÃ 	appar
appareil 	appar
apparente 	appar
apparition 	appar
appel 	appel
appellation 	appel
appelle 	appel
appellent 	appel
appels 	appel
appelÃ 	appel
applicatifs 	appli
application 	appli
applications 	appli
applied 	appli
appliquant 	appliqu
appliquer 	appliqu
appliquÃ 	appliqu
apport 	apport
apportant 	apport
apporte 	apport
apportent 	apport
apporter 	apport
apportÃ 	apport
apprend 	appren
apprendre 	appren
apprentissage 	apprentissage
apprentissages 	apprentissage
appris 	appris 
approche 	approche
approches 	approche
approfondie 	approfondie 
approvisionnement 	approvisionnement 
apprÃ 	apprÃ 
appui 	appui 
appuie 	appuie 
appuyant 	appuyant 
appuyer 	appuyer 
apte 	apte
aptes 	apte
aquatiques 	aquatiques 
aqueuse 	aqueuse 
aquimer 	aquimer 
arbre 	arbre 
arc 	arc 
arcachon 	arcachon 
architecture 	architecture 
archÃ 	archÃ 
areva 	areva 
argent 	argent 
arimnet 	arimnet 
armement 	armement 
armÃ 	armÃ 
arnaud 	arnaud 
array 	array 
arrive 	arrive 
arrivent 	arrivent 
arriver 	arriver 
arrivÃ 	arrivÃ 
arriÃ 	arriÃ 
arrÃªt 	arrÃªt
arrÃªter 	arrÃªt
arrÃªtÃ 	arrÃªt
art 	art 
article 	article
articles 	article
articulant 	articul
articule 	articul
articulent 	articul
articulera 	articul
artificielle 	artificielle 
arÃ 	arÃ 
ascension 	ascension 
asie 	asie 
aspect 	aspect
aspects 	aspect
assemblages 	assembl
assembler 	assembl
assez 	assez 
assiette 	assiette 
assistance 	assist
assiste 	assist
assister 	assist
associant 	associ
association 	associ
associations 	associ
associe 	associ
associer 	associ
associÃ 	associ
assurant 	assur
assure 	assur
assurer 	assur
assurÃ 	assur
astrium 	astr
astrophysique 	astr
atee 	atee 
atelier 	atelier
ateliers 	atelier
atlantique 	atlantique 
atmosphÃ 	atmosphÃ 
atome 	atome 
atomes 	atomes 
atomique 	atomique 
atout 	atout
atouts 	atout
attache 	attache 
attaquer 	attaquer 
atteignait 	atteignait 
atteindre 	atteindre 
atteint 	atteint 
atteinte 	atteinte 
atteintes 	atteintes 
atteints 	atteints 
attend 	attend 
attendant 	attendant 
attendent 	attendent 
attendons 	attendons 
attendre 	attendre 
attendu 	attendu 
attendue 	attendue 
attendues 	attendues 
attendus 	attendus 
attente 	attente 
attentes 	attentes 
attention 	attention 
attirer 	attirer 
attractivitÃ 	attractivitÃ 
attribuÃ 	attribuÃ 
attÃ 	attÃ 
atypique 	atypique 
aucun 	aucun
aucune 	aucun
augmentation 	augment
augmente 	augment
augmenter 	augment
augmentÃ 	augment
auparavant 	auparavant 
auprÃ 	auprÃ 
aura 	aura 
auraient 	auraient 
aurait 	aurait 
auront 	auront 
aussitÃ 	aussitÃ 
austÃ 	austÃ 
autant 	autant 
auteur 	auteur 
authentification 	authentification 
auto 	auto 
automatique 	automatique
automatiquement 	automatique
automatiser 	automati
automatisÃ 	automati
automne 	automne 
automobile 	automobile 
autonome 	autonom
autonomes 	autonom
autonomie 	autonom
autorisant 	autorisant 
autoritÃ 	autoritÃ 
autoroute 	autoroute
autoroutes 	autoroute
autre 	autre
autrefois 	autre
autrement 	autre
autres 	autre
auxquelles 	auxquel
auxquels 	auxquel
avaient 	avaient 
avais 	avais 
avait 	avait 
avance 	avance 
avancer 	avancer 
avancÃ 	avancÃ 
avant 	avant 
avantage 	avantage
avantages 	avantage
avec 	avec 
avenir 	avenir 
aventure 	aventure 
avez 	avez 
aviation 	aviation 
avionneur 	avion
avions 	avion
avis 	avis 
avons 	avons 
avoue 	avoue 
avril 	avril 
avÃ 	avÃ 
axe 	axe 
axes 	axes 
axÃ 	axÃ 
ayant 	ayant 
azote 	azote 
azur 	azur 
aÃ 	aÃ 
bac 	bac 
baccalaurÃ 	baccalaurÃ 
bactÃ 	bactÃ 
balbutiante 	balbutiante 
ballons 	ballons 
banal 	banal 
banc 	banc 
banniÃ 	banniÃ 
baptiste 	baptis
baptisÃ 	baptis
barre 	barre 
bas 	bas 
base 	base 
bases 	bases 
basse 	basse 
basses 	basses 
bassins 	bassins 
basÃ 	basÃ 
bataille 	bataille 
bateaux 	bateaux 
battent 	batte
batterie 	batte
beau 	beau
beaucoup 	beau
bel 	bel 
belge 	belge 
belgique 	belgique 
belle 	belle
belles 	belle
benjamin 	benjamin 
berlin 	berlin 
bernard 	bernard 
besoin 	besoin
besoins 	besoin
bi 	bi 
biais 	biais 
bibliographie 	bibliographie 
bien 	bien
biens 	bien
bientÃ 	bien
big 	big 
bilan 	bilan 
binÃ 	binÃ 
bio 	bio 
biocarburants 	biocarburants 
biochimie 	biochimie 
biocitech 	biocitech 
biodiversitÃ 	biodiversitÃ 
biologie 	biolog
biologique 	biologique
biologiques 	biologique
biologiste 	biologiste
biologistes 	biologiste
biology 	biolog
biomasse 	biomasse 
biomatÃ 	biomatÃ 
biomÃ 	biomÃ 
biopharmaceutique 	biopharmaceutique 
biopolymÃ 	biopolymÃ 
biosimulation 	biosimulation 
biotechnologie 	biotechnologie
biotechnologies 	biotechnologie
biotechnology 	biotechnolog
blanc 	blanc
blanches 	blanc
bloc 	bloc 
bloquant 	bloqu
bloquer 	bloqu
blÃ 	blÃ 
boissons 	boissons 
bon 	bon 
bonne 	bonne
bonnes 	bonne
bons 	bons 
booster 	booster 
bord 	bord
bordeaux 	bord
bordelais 	bord
boucler 	boucl
bouclÃ 	boucl
bougent 	bougent 
bourg 	bourg 
bourgogne 	bourgogne 
bourguignonne 	bourguignonne 
bourlinguÃ 	bourlinguÃ 
boursiers 	boursiers 
bout 	bout 
boÃ 	boÃ 
branche 	branche
branches 	branche
bras 	bras 
bresse 	bresse 
brevet 	brevet
brevets 	brevet
brevetÃ 	brevet
brillamment 	brillamment 
brio 	brio 
brique 	brique
briques 	brique
briser 	briser 
briÃ 	briÃ 
brousse 	brousse 
bruits 	bruits 
bruxelles 	bruxelles 
brÃ 	brÃ 
btp 	btp 
budget 	budget 
bulletins 	bulletins 
bureau 	bureau
bureaux 	bureau
but 	but 
bÃ 	bÃ 
cachan 	cachan 
cahier 	cahier 
calcium 	calcium 
calcul 	calcul
calculer 	calcul
california 	california 
cameroun 	cameroun 
campagnes 	campagnes 
campus 	campus 
camÃ 	camÃ 
canada 	canad
canadienne 	canad
cancÃ 	cancÃ 
candidat 	candidat 
cap 	cap 
capable 	capable
capables 	capable
capacitÃ 	capacitÃ 
capital 	capital
capitale 	capital
capte 	capte 
capter 	capter 
capture 	capture 
car 	car 
caractÃ 	caractÃ 
carbone 	carbone 
carburant 	carburant 
cardiovasculaires 	cardiovasculaires 
carriÃ 	carriÃ 
carrÃ 	carrÃ 
carte 	carte 
cartographie 	cartographie
cartographier 	cartographie
cas 	cas 
catalogue 	catal
catalyse 	catalyse
catalyseurs 	catalyse
catÃ 	catÃ 
cause 	cause 
ce 	ce 
cea 	cea 
ceci 	ceci 
celle 	celle 
celles 	celles 
cellule 	cellule
cellules 	cellule
celui 	celui 
cemes 	cemes 
cent 	cent
centaine 	cent
centaines 	cent
centenaire 	cent
centimÃ 	cent
central 	cent
centrale 	cent
centrales 	cent
centre 	cent
centres 	cent
centrÃ 	cent
cependant 	cependant 
cercle 	cercle 
cerise 	cerise 
certain 	certain
certaine 	certain
certaines 	certain
certains 	certain
certes 	certes 
certification 	certification 
cerveau 	cerveau 
ces 	ces 
cesse 	cesse 
cessent 	cessent 
cesser 	cesser 
cessÃ 	cessÃ 
cet 	cet 
ceux 	ceux 
chacun 	chacun
chacune 	chacun
chain 	chain 
chaire 	chaire 
chaleur 	chaleur 
challenge 	challenge
challenges 	challenge
chambre 	chambre 
champ 	champ 
champion 	champion 
champs 	champs 
chances 	chances 
change 	change 
changement 	changement
changements 	changement
changer 	changer 
changÃ 	changÃ 
chantier 	chantier
chantiers 	chantier
chapitres 	chapitres 
chaque 	chaque 
charge 	charg
chargÃ 	charg
chaudes 	chaudes 
chauffage 	chauffage 
chaÃ 	chaÃ 
chef 	chef 
chefs 	chefs 
chemin 	chemi
cheminement 	chemi
chemistry 	chemi
cherche 	cherch
cherchent 	cherch
chercher 	cherch
chercheur 	cherch
cherchez 	cherch
cherchons 	cherch
cherchÃ 	cherch
chez 	chez 
chiffre 	chiffre
chiffres 	chiffre
chimie 	chimi
chimique 	chimique
chimiquement 	chimique
chimiques 	chimique
china 	china 
chine 	chine 
chinoises 	chinoises 
choc 	choc 
chocs 	chocs 
choisi 	choisi
choisies 	choisi
choisir 	choisi
choisis 	choisi
choix 	choix 
chose 	chose 
chromophore 	chro
chronologie 	chro
chu 	chu 
cible 	cibl
cibles 	cibl
ciblÃ 	cibl
ciel 	ciel 
cinq 	cinq
cinquantaine 	cinquant
cinquantenaire 	cinquant
cinquiÃ 	cinq
cirad 	cirad 
circulation 	circul
circule 	circul
cisaillement 	cisaillement 
citer 	citer 
citoyen 	citoyen
citoyens 	citoyen
civil 	civil
civile 	civil
civiles 	civil
clairement 	clairement 
classe 	class
classes 	class
classique 	classique
classiquement 	classique
classiques 	classique
claude 	claude 
clermont 	clermont 
client 	client
clients 	client
climat 	climat
climatique 	climat
climatiques 	climat
climatologues 	climat
climats 	climat
clinique 	clinique 
clubs 	clubs 
cluster 	cluster
clusters 	cluster
clÃ 	clÃ 
cm 	cm 
cnam 	cnam 
co 	co 
coagulant 	coagulant 
codant 	codant 
code 	code 
codes 	codes 
coeur 	coeur 
cognitive 	cognitive
cognitives 	cognitive
cohÃ 	cohÃ 
col 	col 
collaborateurs 	collaborat
collaboratif 	collaborat
collaboratifs 	collaborat
collaborations 	collaborat
collaborative 	collaborat
collaborent 	collabor
collaborer 	collabor
collecte 	collect
collecter 	collect
collectif 	collect
collection 	collect
collective 	collect
collectives 	collect
collectivitÃ 	collect
collectÃ 	collect
colloque 	colloque 
collÃ 	collÃ 
colombie 	colombie 
colonne 	colonne 
colorants 	colorants 
colossal 	colossal 
colza 	colza 
com 	com 
combien 	combien 
combinaison 	combinaison
combinaisons 	combinaison
combinant 	combinant 
combiner 	combiner 
combustibles 	combustibles 
comitÃ 	comitÃ 
comme 	comme 
commence 	commence 
commencent 	commencent 
commencer 	commencer 
commencÃ 	commencÃ 
comment 	comment 
commenÃ 	commenÃ 
commerce 	commerc
commercial 	commercia
commerciale 	commercia
commerciales 	commercia
commercialisation 	commercialis
commercialise 	commercialis
commercialiser 	commercialis
commercialisÃ 	commercialis
commerciaux 	commercia
commission 	commission 
commun 	commun
communautÃ 	commun
commune 	commun
communes 	commun
communication 	commun
communications 	commun
communiquer 	commun
communs 	commun
compact 	compact 
compagnie 	compagn
compagnon 	compagn
comparable 	comparable
comparables 	comparable
comparaisons 	comparaisons 
compare 	compare 
comparer 	comparer 
comparÃ 	comparÃ 
compatible 	compatible 
complet 	complet 
complexe 	complexe 
complexes 	complexes 
complexitÃ 	complexitÃ 
complications 	complications 
complÃ 	complÃ 
comportant 	comport
comporte 	comport
comportement 	comportement
comportements 	comportement
comportent 	comport
composante 	composant
composantes 	composant
composants 	composant
compose 	compose 
composent 	composent 
composÃ 	composÃ 
comprenant 	comprenant 
comprend 	comprend 
comprendre 	comprendre 
comprenez 	comprenez 
compression 	compression 
compris 	compris 
comprÃ 	comprÃ 
comptent 	compte
compter 	compte
computing 	computing 
compÃ 	compÃ 
comtÃ 	comtÃ 
concentration 	concentr
concentrations 	concentr
concentrer 	concentr
concentrÃ 	concentr
concept 	concept
concepteur 	concept
concepteurs 	concept
conception 	concept
concepts 	concept
concernant 	concern
concerne 	concern
concernent 	concern
concernÃ 	concern
concession 	concession 
concevoir 	concevoir 
concilier 	concilier 
conclusion 	conclusion
conclusions 	conclusion
conclut 	conclu
concourir 	concour
concours 	concour
concrÃ 	concrÃ 
concurrent 	concurrent
concurrentes 	concurrent
condition 	condition
conditionne 	condition
conditionnement 	condition
conditions 	condition
conducteur 	conduct
conduction 	conduct
conduira 	conduira 
conduire 	conduire 
conduisent 	conduisent 
conduite 	conduite
conduites 	conduite
confiance 	confiance 
confirme 	confirm
confirmer 	confirm
confirmÃ 	confirm
confiÃ 	confiÃ 
confondues 	confondues 
confort 	confort
confortables 	confort
confrontÃ 	confrontÃ 
confÃ 	confÃ 
congrÃ 	congrÃ 
conjoint 	conjoint
conjointement 	conjoint
connaissait 	connaiss
connaissance 	connaiss
connaissances 	connaiss
connaissent 	connaiss
connaisseurs 	connaiss
connaissez 	connaiss
connaissions 	connaiss
connaissons 	connaiss
connaÃ 	connaÃ 
connectÃ 	connectÃ 
connu 	connu 
connue 	connue 
connues 	connues 
connus 	connus 
conquÃªte 	conquÃªte 
consacre 	consacr
consacrer 	consacr
consacrÃ 	consacr
conscience 	conscience 
conseil 	conseil
conseils 	conseil
conservant 	conserv
conservateurs 	conserv
conservation 	conserv
conserver 	conserv
considÃ 	considÃ 
consistant 	consist
consiste 	consist
consister 	consist
consistÃ 	consist
consolider 	consolider 
consommateur 	consomm
consommation 	consomm
consomme 	consomm
consomment 	consomm
consommer 	consomm
consommÃ 	consomm
consortium 	consortium 
constant 	constant
constants 	constant
constat 	constat 
constate 	constate 
constatent 	constatent 
constater 	constater 
constatÃ 	constatÃ 
constituait 	constitu
constituants 	constitu
constitue 	constitu
constituent 	constitu
constituerait 	constitu
constituÃ 	constitu
constructeur 	constructeur
constructeurs 	constructeur
construction 	construct
construire 	constru
construisent 	constru
construit 	constru
construite 	constru
consultant 	consult
consulter 	consult
consÃ 	consÃ 
contact 	contact 
contenant 	conten
contenir 	conten
contenter 	conten
contenu 	conten
contient 	contient 
continent 	continent
continentales 	continent
continentaux 	continent
continu 	continu 
continue 	continue 
continuer 	continuer 
continuitÃ 	continuitÃ 
continuum 	continuum 
contraction 	contraction 
contradictoires 	contradictoires 
contraintes 	contraintes 
contraire 	contraire
contrairement 	contraire
contrastÃ 	contrastÃ 
contrat 	contrat 
contrats 	contrats 
contre 	contre 
contribuant 	contribu
contribue 	contribu
contribuent 	contribu
contribuer 	contribu
contribuera 	contribu
contribution 	contribu
contributions 	contribu
contribuÃ 	contribu
contrÃ 	contrÃ 
convaincre 	convainc
convaincu 	convainc
convaincus 	convainc
convention 	convention 
convergence 	convergence 
conviction 	conviction 
convoyeurs 	convoyeurs 
conÃ 	conÃ 
coopÃ 	coopÃ 
coordinateur 	coordinat
coordination 	coordinat
coordonne 	coordonn
coordonner 	coordonn
coordonnÃ 	coordonn
coque 	coque 
corps 	corps 
correspond 	correspond
correspondait 	correspond
correspondant 	correspond
correspondent 	correspond
corriger 	corriger 
cosmÃ 	cosmÃ 
cote 	cote 
couches 	couches 
couleurs 	couleurs 
coulisses 	coulisses 
council 	council 
coup 	coup 
couper 	couper 
couplage 	couplage 
couplÃ 	couplÃ 
coupÃ 	coupÃ 
couramment 	couramment 
courant 	courant
courante 	courant
course 	course 
court 	court 
courtes 	courtes 
courts 	courts 
couvertes 	couvertes 
couvrant 	couvrant 
couvre 	couvre 
couvrent 	couvrent 
couvrir 	couvrir 
coÃ 	coÃ 
criblage 	criblage 
cristalline 	cristalline 
critiques 	critiques 
critÃ 	critÃ 
croire 	croire 
croise 	croise 
croisement 	croisement 
croissance 	croissan
croissant 	croissan
croissante 	croissan
croisÃ 	croisÃ 
croÃ 	croÃ 
crucial 	crucial 
crÃ 	crÃ 
cube 	cube 
cuisson 	cuisson 
culinaires 	culinaires 
cultiver 	cultiv
cultivÃ 	cultiv
culturale 	cultur
culture 	cultur
culturel 	cultur
culturelle 	cultur
culturels 	cultur
cultures 	cultur
curie 	curi
curiositÃ 	curi
cycle 	cycle
cycles 	cycle
cÃ 	cÃ 
danemark 	danemark 
danger 	danger
dangereux 	danger
danois 	danois 
dassault 	dassault 
data 	data 
datant 	datant 
date 	date 
datÃ 	datÃ 
davantage 	davantage 
degrÃ 	degrÃ 
dehors 	dehors 
delÃ 	delÃ 
demain 	demain 
demande 	demand
demander 	demand
demandes 	demand
demandeur 	demand
demandÃ 	demand
demeure 	demeure 
demi 	demi 
dense 	dens
denses 	dens
densification 	dens
densitÃ 	dens
depuis 	depuis 
dermatologie 	dermatologie 
dernier 	dernier
derniers 	dernier
derniÃ 	derni
descente 	descente 
design 	design 
desquelles 	desquel
desquels 	desquel
dessinent 	dessin
dessiner 	dessin
dessinÃ 	dessin
dessus 	dessus 
destination 	destin
destinÃ 	destin
destruction 	destructi
destructive 	destructi
deux 	deux
deuxiÃ 	deux
devait 	devait 
devant 	devant 
devenant 	deven
devenir 	deven
devenu 	deven
devenue 	deven
devenues 	deven
deviennent 	devien
devient 	devien
devoir 	devoir 
devons 	devons 
devraient 	devraient 
devront 	devront 
diabÃ 	diabÃ 
diagnostic 	diagnosti
diagnostiquer 	diagnostiqu
diagnostiquÃ 	diagnostiqu
dialogue 	dialogue
dialoguer 	dialogue
didactique 	didactique
didactiques 	didactique
diderot 	diderot 
difficile 	difficile
difficilement 	difficile
difficiles 	difficile
difficultÃ 	diff
diffuser 	diff
diffusion 	diff
diffÃ 	diff
digestives 	digestives 
dijon 	dijon
dijonnais 	dijonnais
dijonnaise 	dijonnais
dimension 	dimension
dimensions 	dimension
diminuer 	diminu
diminution 	diminu
diminuÃ 	diminu
diode 	diode
diodes 	diode
dioxyde 	dioxyde 
diplÃ 	diplÃ 
dira 	dira 
direct 	direct
directement 	direct
directes 	direct
directeur 	direct
directeurs 	direct
direction 	direct
directions 	direct
directrice 	direct
directs 	direct
dirige 	dirig
dirigeait 	dirig
dirigÃ 	dirig
discipline 	discipline
disciplines 	discipline
discovery 	discovery 
discussions 	discussions 
discuter 	discuter 
disparaÃ 	dispar
disparition 	dispar
disparu 	dispar
dispense 	dispens
dispenser 	dispens
dispensÃ 	dispens
disperse 	dispers
disperser 	dispers
dispersÃ 	dispers
disponibilitÃ 	disponib
disponible 	disponible
disponibles 	disponible
disposaient 	disposaient 
disposait 	disposait 
disposant 	disposant 
dispose 	dispose 
disposent 	disposent 
disposer 	disposer 
disposera 	disposera 
disposeront 	disposeront 
dispositif 	dispositi
dispositifs 	dispositi
disposition 	dispositi
disposons 	disposons 
distance 	distance
distances 	distance
distinction 	distinction 
distribuer 	distribu
distributeurs 	distribu
distribution 	distribu
dite 	dite 
dites 	dites 
dits 	dits 
divers 	divers
diverses 	divers
diversifier 	divers
diversitÃ 	divers
divisÃ 	divisÃ 
dix 	dix 
dizaine 	dizaine
dizaines 	dizaine
docteur 	docteur
docteurs 	docteur
doctoral 	doctora
doctorat 	doctora
doit 	doit 
doivent 	doivent 
dollars 	dollars 
domotique 	domotique 
donnant 	donn
donne 	donn
donnent 	donn
donner 	donn
donnera 	donn
donnÃ 	donn
dosage 	dosage 
dose 	dose 
doter 	doter 
dotÃ 	dotÃ 
double 	double
doublement 	double
doubler 	double
doute 	doute
douter 	doute
douzaine 	douzaine 
douze 	douze 
dresse 	dress
dresser 	dress
dressÃ 	dress
drogues 	drogues 
droit 	droit 
dsm 	dsm 
du 	du 
dual 	dual 
due 	due 
dues 	dues 
duquel 	duquel 
durabilitÃ 	durabilitÃ 
durable 	durable
durables 	durable
durant 	durant 
durÃ 	durÃ 
dut 	dut 
dynamique 	dynamique
dynamiques 	dynamique
dÃ 	dÃ 
eads 	eads 
eau 	eau 
eaux 	eaux 
ecole 	ecole 
ecologie 	ecolog
ecology 	ecolog
economie 	econom
economique 	econom
economy 	econom
ecosse 	ecosse 
edimbourg 	edimbourg 
editeur 	editeur 
editions 	editions 
education 	education 
effectifs 	effect
effectivement 	effect
effectuant 	effect
effectue 	effect
effectuent 	effect
effectuer 	effect
effectuerons 	effect
effectuÃ 	effect
effets 	effets 
efficace 	efficac
efficacement 	efficac
efficaces 	efficac
efficacitÃ 	efficac
efficience 	effic
effluents 	effluents 
effondrÃ 	effondrÃ 
effort 	effort
efforts 	effort
egalement 	egalement 
egypte 	egypte 
ehpad 	ehpad 
electric 	electr
electro 	electr
electronique 	electronique
electroniques 	electronique
elle 	elle
elles 	elle
emballage 	emball
emballÃ 	emball
embarquÃ 	embarquÃ 
embauche 	embauche
embaucher 	embauche
emblÃ 	emblÃ 
embryon 	embryon 
emm 	emm 
emmener 	emmener 
empiler 	empiler 
emplacement 	emplacement 
emploi 	emploi 
emplois 	emplois 
employÃ 	employÃ 
empreinte 	empreinte 
empÃªche 	empÃªche
empÃªcher 	empÃªche
enclin 	enclin 
encourageants 	encourage
encourager 	encourage
endocrine 	endocrin
endocrinologie 	endocrin
endommager 	endommag
endommagÃ 	endommag
endÃ 	endÃ 
energie 	energ
energies 	energ
energy 	energ
energÃ 	energ
enfance 	enfan
enfant 	enfan
enfermer 	enfermer 
engage 	engag
engagement 	engag
engagÃ 	engag
engendrÃ 	engendrÃ 
engineering 	engineering 
engouement 	engouement 
enjeu 	enjeu
enjeux 	enjeu
enregistre 	enregistre
enregistrer 	enregistre
enrichies 	enrichi
enrichir 	enrichi
ens 	ens 
ensam 	ensam 
ensbana 	ensbana 
enseignants 	enseign
enseignement 	enseignement
enseignements 	enseignement
enseigner 	enseign
ensuite 	ensuite 
entamer 	entam
entamÃ 	entam
entend 	entend
entendre 	entend
enthousiasme 	enthousias
enthousiaste 	enthousias
entier 	entier 
entitÃ 	entitÃ 
entiÃ 	entiÃ 
entoure 	entoure 
entraÃ 	entraÃ 
entre 	entre 
entreprendre 	entrepren
entrepreneuriale 	entrepreneuria
entrepreneuriat 	entrepreneuria
entrepris 	entrepris
entreprise 	entrepris
entreprises 	entrepris
entrer 	entrer 
entretenir 	entretenir 
entrevoir 	entrevoir 
entrÃ 	entrÃ 
envahi 	envahi 
enveloppe 	enveloppe 
envergure 	envergure 
envers 	envers 
envie 	envie 
environ 	environ
environment 	environ
environnement 	environnement
environnemental 	environnement
environnementale 	environnement
environnementales 	environnement
environnementaux 	environnement
environnements 	environnement
envisage 	envisag
envisageable 	envisageable
envisageables 	envisageable
envisagent 	envisag
envisageons 	envisag
envisager 	envisag
envisagÃ 	envisag
envoyer 	envoy
envoyÃ 	envoy
ephe 	ephe 
eppn 	eppn 
equateur 	equateur 
equipement 	equipement 
er 	er 
erasmus 	erasmus 
ergonomiques 	ergonomiques 
erreur 	erreur
erreurs 	erreur
escales 	escales 
espace 	espace 
espagne 	espagne 
espoir 	espoir 
esprit 	esprit 
espÃ 	espÃ 
esquisse 	esquisse
esquisser 	esquisse
essai 	essai 
essayant 	essayant 
essayer 	essayer 
essayons 	essayons 
essayÃ 	essayÃ 
essentiel 	essentiel
essentiellement 	essentiel
essentielles 	essentiel
essentiels 	essentiel
est 	est 
estimant 	estim
estimation 	estim
estiment 	estim
estimer 	estim
estimons 	estim
estomac 	estomac 
estuaires 	estuaires 
etat 	etat
etats 	etat
etc 	etc 
etudes 	etud
etudiants 	etud
eu 	eu 
eurobiomed 	euro
eurocopter 	euro
european 	euro
europÃ 	euro
euros 	euro
eux 	eux 
evolution 	evolution 
ex 	ex 
exactement 	exactement 
examens 	examens 
excellence 	excellen
excellente 	excellen
exception 	exception
exceptionnel 	exceptionnel
exceptionnelle 	exceptionnel
exceptionnelles 	exceptionnel
exceptionnels 	exceptionnel
exclame 	exclame 
exclusif 	exclusi
exclusive 	exclusi
exclusivement 	exclusi
exclusivitÃ 	exclusi
executive 	executive 
exemplaires 	exempl
exemples 	exempl
exercice 	exercice 
exige 	exige
exigeant 	exige
exigences 	exige
existait 	exist
existant 	existant
existante 	existant
existantes 	existant
existants 	existant
existe 	exist
existence 	exist
existent 	exist
exister 	exist
experimental 	exper
expert 	exper
expertise 	expertise
expertises 	expertise
experts 	exper
expliquent 	expliqu
expliquer 	expliqu
expliquÃ 	expliqu
exploitation 	exploit
exploiter 	exploit
exploitÃ 	exploit
exploration 	exploration 
explore 	explore 
explorer 	explorer 
explorÃ 	explorÃ 
export 	export
exporter 	export
exposants 	exposants 
expose 	expose 
exposer 	exposer 
exposition 	exposition
expositions 	exposition
exposÃ 	exposÃ 
expÃ 	expÃ 
externe 	externe 
extia 	extia 
extraire 	extraire 
extrait 	extrait 
extraordinaire 	extraordinaire
extraordinaires 	extraordinaire
extrÃªme 	extrÃªme
extrÃªmes 	extrÃªme
extÃ 	extÃ 
exÃ 	exÃ 
fabricants 	fabrica
fabrication 	fabrica
fabrique 	fabriqu
fabriquer 	fabriqu
fabriquÃ 	fabriqu
face 	face 
faciale 	faciale 
facile 	facile 
facilement 	facilement 
faciles 	faciles 
facilitant 	facilit
facilite 	facilit
facilitent 	facilit
faciliter 	facilit
facility 	facilit
facilitÃ 	facilit
facteur 	facteur
facteurs 	facteur
faible 	faible
faibles 	faible
faiblesse 	faible
faim 	faim 
faire 	faire 
faisait 	faisait 
faisant 	faisant 
faisons 	faisons 
faite 	faite
faites 	faite
fallait 	fall
falloir 	fall
fameuse 	fameuse
fameuses 	fameuse
fameux 	fameu
familiariser 	famil
famille 	famille
familles 	famille
faudra 	faudra
faudrait 	faudra
fausse 	fausse 
faute 	faute 
favorable 	favor
favoriser 	favor
feder 	feder 
fera 	fera 
ferme 	ferme 
fermeture 	fermeture 
fermÃ 	fermÃ 
feront 	feront 
ferrand 	ferrand 
feu 	feu 
feuille 	feuille
feuilles 	feuille
fiable 	fiable
fiables 	fiable
fiches 	fiches 
fiers 	fier
fiertÃ 	fier
figure 	figure 
fil 	fil 
filiale 	filiale 
filiÃ 	filiÃ 
film 	film 
fils 	fils 
filtration 	filtr
filtre 	filtr
filtres 	filtr
fin 	fin 
final 	final 
finale 	finale 
finalement 	finalement 
finalisation 	finalisation 
finalitÃ 	finalitÃ 
finance 	financ
financement 	financ
financements 	financ
financer 	financ
financeurs 	financ
financier 	financ
financiers 	financ
financiÃ 	financ
financÃ 	financ
fine 	fine 
fines 	fines 
fini 	fini 
finir 	finir 
finisse 	finisse 
finlande 	finlande 
fins 	fins 
fission 	fiss
fissures 	fiss
fixes 	fixes 
fixÃ 	fixÃ 
fleurs 	fleurs 
flexibilitÃ 	flexib
flexibles 	flexib
flore 	flore 
fluide 	fluid
fluides 	fluid
fluiditÃ 	fluid
flux 	flux 
flÃ 	flÃ 
focaliser 	focaliser 
focus 	focus 
foliaire 	foliaire 
fonction 	fonction
fonctionnalisation 	fonction
fonctionnalitÃ 	fonction
fonctionnant 	fonction
fonctionne 	fonction
fonctionnelle 	fonction
fonctionnelles 	fonction
fonctionnement 	fonction
fonctionnent 	fonction
fonctionner 	fonction
fonctions 	fonction
fond 	fond 
fondamental 	fondamenta
fondamentale 	fondamenta
fondamentales 	fondamenta
fondamentaux 	fondamenta
fondant 	fondant 
fondateur 	fondateur
fondateurs 	fondateur
fondation 	fondation 
fonde 	fonde 
fonds 	fonds 
fondÃ 	fondÃ 
font 	font 
for 	for 
force 	force 
forcÃ 	forcÃ 
forestiÃ 	forestiÃ 
formant 	formant 
formation 	formation
formations 	formation
forme 	forme 
forment 	forment 
former 	former 
formidable 	formidable
formidables 	formidable
formons 	formons 
formuler 	formuler 
formÃ 	formÃ 
fort 	fort 
forte 	forte 
fortement 	fortement 
fortes 	fortes 
forts 	forts 
forum 	forum 
forÃªts 	forÃªts 
fossile 	fossile 
fouilles 	fouilles 
foulÃ 	foulÃ 
four 	four 
fourier 	fourier 
fourmille 	fourmille 
fourni 	fourni
fournies 	fourni
fournir 	fourni
fournira 	fourni
fournis 	fourni
fournisseurs 	fourni
fournit 	fourni
fourniture 	fourni
fr 	fr 
fraction 	fraction 
fragile 	fragil
fragiles 	fragil
fragilitÃ 	fragil
fragment 	fragment 
frais 	frais 
franc 	franc 
franche 	franche 
franchi 	franchi 
franchir 	franchir 
franchit 	franchit 
francilienne 	francilienne 
franco 	franco 
francophone 	francophone 
franÃ 	franÃ 
frappÃ 	frappÃ 
freinage 	frein
freins 	frein
fresnel 	fresnel 
fromager 	fromag
fromagÃ 	fromag
front 	front
frontiÃ 	front
fruit 	fruit 
frÃ 	frÃ 
fui 	fui 
fuites 	fuites 
fumÃ 	fumÃ 
fur 	fur 
furent 	furent 
fusion 	fusion 
fusÃ 	fusÃ 
fut 	fut 
futur 	futur
future 	futur
futures 	futur
futurs 	futur
fÃ 	fÃ 
fÃªtÃ 	fÃªtÃ 
gagner 	gagn
gagnÃ 	gagn
gain 	gain
gains 	gain
gallium 	gallium 
gamme 	gamme 
garantie 	garanti
garantir 	garanti
garantissant 	garanti
garantit 	garanti
garder 	garder 
garonne 	garonne 
gastro 	gastro 
genet 	genet 
geneviÃ 	geneviÃ 
genre 	genre 
gens 	gens 
genÃ 	genÃ 
geste 	gest
gestion 	gestion
gestionnaires 	gestion
gigantesque 	giga
gigaoctets 	giga
global 	global
globale 	global
globalement 	global
globales 	global
globalitÃ 	global
globe 	glob
gobain 	gobain 
golfe 	golfe 
google 	google 
gouvernance 	gouvernance 
goÃ 	goÃ 
graines 	graines 
grand 	grand
grande 	grand
grandement 	grand
grandeur 	grand
grandir 	grand
grappes 	grappes 
gravitÃ 	gravitÃ 
grecs 	grecs 
greffe 	greff
greffÃ 	greff
grenelle 	grenelle 
grenoble 	grenobl
grenoblois 	grenobl
gros 	gros 
grossir 	grossir 
groupe 	groupe
groupement 	groupe
groupements 	groupe
groupes 	groupe
grÃ 	grÃ 
guidÃ 	guidÃ 
guise 	guise 
gustative 	gustative 
guyane 	guyane 
gÃ 	gÃ 
habitants 	habit
habitat 	habit
habitation 	habit
habitudes 	habit
habituÃ 	habit
haleine 	haleine 
hasard 	hasard 
hausse 	hausse 
haut 	haut 
haute 	haute 
hautement 	hautement 
hautes 	hautes 
hauteur 	hauteur 
heure 	heure
heures 	heure
hexagone 	hexagone 
high 	high 
histoire 	histoire
histoires 	histoire
historique 	historique
historiques 	historique
hollandais 	hollandais 
hommage 	hommage 
homme 	homme 
hommes 	hommes 
homogÃ 	homogÃ 
homologues 	homologues 
honneur 	honneur 
horaires 	horaires 
horizon 	horizon
horizons 	horizon
hors 	hors 
hospitalier 	hospitalier 
hp 	hp 
http 	http 
huit 	huit 
humain 	humain
humaine 	humain
humaines 	humain
humains 	humain
humanitÃ 	humanitÃ 
humanoÃ 	humanoÃ 
humeur 	humeur 
humiditÃ 	humiditÃ 
humour 	humour 
hybride 	hybride 
hydrodynamique 	hydro
hydrologique 	hydro
hydrophobes 	hydro
hypothÃ 	hypothÃ 
hÃ 	hÃ 
ibitec 	ibitec 
ici 	ici 
identification 	identifi
identifier 	identifi
identifiÃ 	identifi
identique 	identique
identiques 	identique
idÃ 	idÃ 
iii 	iii 
ile 	ile 
illustrant 	illustr
illustration 	illustr
illustre 	illustr
illustrer 	illustr
illustrÃ 	illustr
ils 	ils 
image 	imag
imager 	imag
imagerie 	imag
images 	imag
imageur 	imag
imagination 	imagin
imagine 	imagin
imaginer 	imagin
imaginez 	imagin
immense 	immense
immenses 	immense
immergÃ 	immergÃ 
immersion 	immersion 
immunothÃ 	immunothÃ 
immÃ 	immÃ 
impact 	impact
impacte 	impact
impacts 	impact
impatiemment 	impatiemment 
imperfections 	imperfections 
implantation 	implant
implanter 	implant
implantÃ 	implant
implication 	implication
implications 	implication
implique 	impliqu
impliquer 	impliqu
impliquÃ 	impliqu
importance 	importan
importantes 	importan
importants 	importan
importe 	import
impose 	impose 
imposer 	imposer 
impossibilitÃ 	impossib
impossible 	impossib
imprimÃ 	imprimÃ 
impulsion 	impulsion 
impÃ 	impÃ 
in 	in 
inattendu 	inattendu 
inaugural 	inaugur
inauguration 	inaugur
inaugurÃ 	inaugur
incapable 	incapa
incapacitÃ 	incapa
incendies 	incendies 
incidence 	inciden
incident 	inciden
inciter 	inciter 
incluant 	incluant 
incontestable 	incont
incontournable 	incontournable
incontournables 	incontournable
incubateur 	incubat
incubation 	incubat
indicateur 	indicat
indications 	indicat
indien 	indien
indiens 	indien
indiquer 	indiqu
indiquÃ 	indiqu
indirects 	indirects 
indispensable 	indispensable
indispensables 	indispensable
individu 	individu
individuelle 	individu
individuels 	individu
individus 	individu
induisent 	induisent 
induit 	induit 
induite 	induite 
induits 	induits 
industrialisation 	industrialis
industrialiser 	industrialis
industrialisÃ 	industrialis
industrie 	industri
industriel 	industri
industrielle 	industrielle
industrielles 	industrielle
industries 	industri
indÃ 	indÃ 
inertielle 	inertielle 
ines 	ines 
infectieux 	infecti
infections 	infecti
infime 	infime
infimes 	infime
influence 	influence
influencer 	influence
influer 	influe
informaticien 	informati
information 	informati
informations 	informati
informatique 	informati
informer 	inform
infrastructure 	infrastructure 
infÃ 	infÃ 
ingrÃ 	ingrÃ 
ingÃ 	ingÃ 
inhibe 	inhibe 
initiale 	initiale
initialement 	initiale
initiales 	initiale
initiateurs 	initi
initiation 	initi
initiative 	initi
initier 	initi
initiÃ 	initi
injection 	injection 
inlassablement 	inlassablement 
innov 	innov
innovant 	innovant
innovante 	innovant
innovantes 	innovant
innovants 	innovant
innovateurs 	innov
innovation 	innov
innovations 	innov
innovatives 	innov
innove 	innov
innovent 	innov
innover 	innov
inra 	inra 
inria 	inria 
insa 	insa 
inscriptions 	inscri
inscrit 	inscri
inscrite 	inscri
insensible 	insensible 
inserm 	inserm 
insertion 	insertion 
inspirant 	inspir
inspirer 	inspir
instabilitÃ 	instabilitÃ 
installation 	install
installer 	install
installÃ 	install
instant 	instant 
instar 	instar 
instauration 	instauration 
institut 	institut
institute 	institut
institution 	institut
institutionnels 	institut
institutions 	institut
instituts 	institut
instrumentation 	instrument
instrumentÃ 	instrument
integrated 	integrated 
intellectuelle 	intell
intelligence 	intelligen
intelligent 	intelligen
intelligents 	intelligen
intempÃ 	intempÃ 
intense 	intense 
intensif 	intensif 
intensification 	intensification 
intensifier 	intensifier 
intensitÃ 	intensitÃ 
intention 	intention 
inter 	inter 
interaction 	interaction
interactions 	interaction
interdisciplinaires 	interdisciplinaires 
interface 	interface
interfaces 	interface
interlocuteur 	interlocuteur 
interministÃ 	interministÃ 
intermittentes 	intermittentes 
intermÃ 	intermÃ 
international 	internationa
internationale 	internationa
internationales 	internationa
internationaux 	internationa
interne 	interne 
internet 	internet 
interroge 	interroge
interrogent 	interroge
interroger 	interroge
intervenant 	interven
intervenir 	interven
intervenons 	interven
intervention 	interven
interventions 	interven
intestinale 	intestinale
intestinales 	intestinale
intimes 	intimes 
intitulÃ 	intitulÃ 
intra 	intra 
intrants 	intrants 
intrinsÃ 	intrinsÃ 
introduction 	introdu
introduit 	introdu
intÃ 	intÃ 
invasive 	invasive 
inventer 	invent
inventeurs 	invent
invention 	invent
inverse 	invers
inverser 	invers
inversÃ 	invers
investir 	investi
investissement 	investissement
investissements 	investissement
investisseurs 	investisse
invitent 	invit
invitÃ 	invit
inÃ 	inÃ 
ions 	ions 
ipcms 	ipcms 
ird 	ird 
irrigation 	irrigation 
irrÃ 	irrÃ 
isolant 	isol
isolation 	isol
isolÃ 	isol
issu 	issu
issue 	issu
issues 	issu
issus 	issu
italie 	italie
italien 	italie
italienne 	italie
jacques 	jacques 
jamais 	jamais 
jambes 	jambes 
james 	james 
janvier 	janvier 
japon 	japon
japonais 	japonais
japonaise 	japonais
jardins 	jardins 
je 	je 
jean 	jean 
jeu 	jeu 
jeune 	jeune
jeunes 	jeune
jeux 	jeux 
josas 	josas 
joseph 	joseph 
joue 	joue 
jouent 	jouent 
jouer 	jouer 
journal 	journal 
journÃ 	journÃ 
jours 	jours 
jouy 	jouy 
jouÃ 	jouÃ 
joyeuse 	joyeuse 
judicieux 	judicieux 
juillet 	juillet 
juin 	juin 
jury 	jury 
jusqu 	jusqu
jusque 	jusqu
juste 	juste 
kg 	kg 
kourou 	kourou 
kyoto 	kyoto 
laas 	laas 
lab 	lab 
label 	label
labellisÃ 	label
laboratoire 	laboratoire 
lacs 	lacs 
laisse 	laisse
laissent 	laisse
laisser 	laisse
lait 	lait 
lance 	lance 
lancement 	lancement 
lancer 	lancer 
lancÃ 	lancÃ 
langue 	langue
languedoc 	langue
largement 	large
largeur 	large
larves 	larves 
laser 	laser
lasers 	laser
laurÃ 	laurÃ 
le 	le 
leader 	leader
leaders 	leader
lecteur 	lecteur
lecteurs 	lecteur
leibler 	leibler 
lendemain 	lendemain 
lent 	lent 
lentes 	lentes 
ler 	ler 
lesieur 	lesieur 
lesquelles 	lesquel
lesquels 	lesquel
letters 	letters 
leur 	leur
leurre 	leur
leurs 	leur
levant 	levant 
lever 	lever 
leviers 	leviers 
levÃ 	levÃ 
liaison 	liaison
liaisons 	liaison
libertÃ 	libertÃ 
libre 	libre 
libye 	libye 
libÃ 	libÃ 
licence 	licence
licences 	licence
lien 	lien 
liens 	liens 
lieu 	lieu 
lieux 	lieux 
ligne 	ligne
lignes 	ligne
limitant 	limit
limitation 	limit
limitations 	limit
limite 	limit
limiter 	limit
limites 	limit
limitrophes 	limit
limitÃ 	limit
linÃ 	linÃ 
lion 	lion 
liquide 	liquide
liquides 	liquide
lire 	lire 
list 	list 
lithium 	lithium 
littÃ 	littÃ 
livrer 	livr
livres 	livr
livrÃ 	livr
liÃ 	liÃ 
local 	loca
locale 	loca
localement 	loca
locales 	loca
localisation 	localis
localiser 	localis
localisÃ 	localis
locaux 	loca
logiciel 	logiciel
logicielle 	logiciel
logiciels 	logiciel
logiques 	logi
logistique 	logi
loi 	loi 
loin 	loin 
lointains 	lointains 
loire 	loire 
loisirs 	loisirs 
longtemps 	long
longue 	longue
longues 	longue
longueur 	longue
longÃ 	long
lors 	lors
lorsqu 	lorsqu
lorsque 	lorsqu
lourd 	lourd
lourde 	lourd
lourds 	lourd
lpo 	lpo 
ludwik 	ludwik 
lui 	lui 
lumineuses 	lumineu
lumineux 	lumineu
lumiÃ 	lumi
lutte 	lutte
lutter 	lutte
lycÃ 	lycÃ 
lyon 	lyon
lyonbiopÃ 	lyon
lÃ 	lÃ 
ma 	ma 
machines 	machines 
macromolÃ 	macromolÃ 
magasin 	magasin 
magazine 	magazine 
magnÃ 	magnÃ 
mai 	mai 
main 	main 
mains 	mains 
maintenant 	mainten
maintenir 	mainten
maison 	maison
maisons 	maison
majeur 	majeur
majeure 	majeur
majeures 	majeur
majeurs 	majeur
majoritÃ 	majoritÃ 
mal 	mal 
malades 	malad
maladies 	malad
malgrÃ 	malgrÃ 
management 	management 
manger 	mange
mangeurs 	mange
manifestation 	manifestation
manifestations 	manifestation
manips 	manips 
manipuler 	manipuler 
manque 	manque 
maquette 	maquette 
marc 	marc 
marchandises 	marchandises 
marche 	marche 
marchÃ 	marchÃ 
mardi 	mardi 
mariage 	mariage 
mariani 	mariani 
marie 	marie 
marines 	marines 
marins 	marins 
maritime 	maritime 
marne 	marne 
marquants 	marqu
marque 	marqu
marqueurs 	marqu
marquÃ 	marqu
mars 	mars 
masquer 	masquer 
massachusetts 	massachusetts 
massif 	massif 
massivement 	massivement 
master 	master
masters 	master
mathÃ 	mathÃ 
matin 	matin 
matiÃ 	matiÃ 
maturation 	matur
maturitÃ 	matur
matÃ 	matÃ 
mauvais 	mauvais 
maximum 	maximum 
mayonnaise 	mayonnaise 
maÃ 	maÃ 
me 	me 
medicen 	medicen 
meilleur 	meilleur
meilleure 	meilleur
meilleures 	meilleur
meilleurs 	meilleur
membre 	membre
membres 	membre
menace 	menace 
menant 	menant 
mener 	mener 
menons 	menons 
mensuel 	mensuel 
menÃ 	menÃ 
mers 	mers 
merveilles 	merveilles 
mesurant 	mesur
mesure 	mesur
mesurer 	mesur
mesures 	mesur
mesurÃ 	mesur
met 	met 
metahit 	metahit 
mettant 	mettant 
mettent 	mettent 
mettra 	mettra 
mi 	mi 
micalis 	micalis 
michel 	michel
michelin 	michel
micro 	micro
microalgues 	micro
microbien 	micro
microbiologique 	micro
microbiologiques 	micro
micromÃ 	micro
microprocesseurs 	micro
microscope 	micro
microscopie 	micro
microscopique 	micro
microscopiques 	micro
microtechniques 	micro
microÃ 	micro
midi 	midi 
migrateur 	migrateur 
milieu 	milieu
milieux 	milieu
militaire 	militaire
militaires 	militaire
mille 	mille 
milliard 	milliard
milliards 	milliard
millier 	millier
milliers 	millier
millimÃ 	millimÃ 
million 	million
millions 	million
mince 	mince
minces 	mince
miniaturisÃ 	miniaturisÃ 
miniers 	miniers 
minimum 	minimum 
ministre 	ministre
ministres 	ministre
ministÃ 	minist
minute 	minute
minutes 	minute
minÃ 	minÃ 
miracle 	miracle 
miroirs 	miroirs 
mis 	mis 
miser 	miser 
mises 	mises 
mission 	mission
missions 	mission
mit 	mit 
mixte 	mixte
mixtes 	mixte
mobile 	mobil
mobiles 	mobil
mobilier 	mobil
mobilisation 	mobil
mobilise 	mobil
mobilisÃ 	mobil
mobilitÃ 	mobil
mode 	mode 
moderne 	moderne
modernes 	moderne
modes 	modes 
modifiant 	modifi
modification 	modifi
modifier 	modifi
modifiÃ 	modifi
module 	module 
modÃ 	modÃ 
moindre 	moindre
moindres 	moindre
moisson 	moisson 
moitiÃ 	moitiÃ 
molle 	molle 
molÃ 	molÃ 
moment 	moment
moments 	moment
mon 	mon 
mondes 	mondes 
mondial 	mondia
mondiale 	mondia
mondialement 	mondia
mondialisation 	mondia
mondiaux 	mondia
montagne 	montagne
montagnes 	montagne
montant 	montant 
monte 	monte 
montpellier 	montpellier 
montrant 	montrant 
montre 	montre 
montrent 	montrent 
montrer 	montrer 
montrÃ 	montrÃ 
mort 	mort 
mot 	mot 
moteur 	moteur
moteurs 	moteur
motif 	motif 
motion 	motion 
mots 	mots 
mouvement 	mouvement 
moyen 	moyen
moyenne 	moyen
moyennes 	moyen
moyens 	moyen
mulhouse 	mulhouse 
multi 	multi
multidisciplinaire 	multi
multimedia 	multi
multiples 	multi
multiplication 	multi
multiplient 	multi
multiplier 	multi
multitude 	multi
muqueuse 	muqueuse 
mur 	mur 
murs 	murs 
musÃ 	musÃ 
mutations 	mutations 
mw 	mw 
myologie 	myologie 
mÃ 	mÃ 
mÃªme 	mÃªme
mÃªmes 	mÃªme
naissance 	naissance 
nano 	nano 
nanomatÃ 	nanomatÃ 
nanomÃ 	nanomÃ 
nanosciences 	nanosciences 
nantes 	nantes 
napolÃ 	napolÃ 
nash 	nash 
national 	nationa
nationale 	nationa
nationales 	nationa
nationaux 	nationa
nature 	nature
naturel 	nature
naturelle 	naturelle
naturellement 	naturelle
naturelles 	naturelle
naturels 	nature
naval 	naval 
naviguer 	naviguer 
naÃ 	naÃ 
ne 	ne 
necker 	necker 
nems 	nems 
nerveuse 	nerveuse 
nette 	nette
nettement 	nette
neuf 	neuf 
neurobiologie 	neuro
neurodÃ 	neuro
neurologue 	neuro
neurologues 	neuro
neurosciences 	neuro
neutrinos 	neutr
neutroniques 	neutr
new 	new 
ni 	ni 
niche 	niche 
niveaux 	niveaux 
noires 	noires 
nom 	nom 
nombreuses 	nombreuses 
noms 	noms 
non 	non 
nord 	nord 
normal 	normal 
normale 	normale 
normandie 	normandie 
normes 	normes 
norvÃ 	norvÃ 
nos 	nos 
note 	note 
noter 	noter 
notons 	notons 
notoriÃ 	notoriÃ 
notre 	notre 
nouer 	nouer 
nourrir 	nourri
nourrisson 	nourri
nourrit 	nourri
nourriture 	nourri
nous 	nous 
nouveautÃ 	nouve
nouvel 	nouve
nouvelle 	nouvelle
nouvellement 	nouvelle
nouvelles 	nouvelle
nouÃ 	nouÃ 
novateur 	novateur 
novembre 	novembre 
nuage 	nuage
nuageuse 	nuage
nullement 	nullement 
numÃ 	numÃ 
nutriments 	nutri
nutrition 	nutrition
nutritionnelle 	nutritionnelle
nutritionnelles 	nutritionnelle
nÃ 	nÃ 
objectif 	objecti
objectifs 	objecti
objective 	objecti
objets 	obje
obligation 	obligat
obligatoirement 	obligat
observant 	observ
observation 	observ
observatoire 	observ
observe 	observ
observent 	observ
observer 	observ
observing 	observ
observÃ 	observ
obstacles 	obstacles 
obtenir 	obten
obtention 	obten
obtenu 	obten
obtenue 	obten
obtenues 	obten
obtenus 	obten
obtient 	obtient 
occident 	occident
occidentale 	occident
occidentaux 	occident
occupe 	occupe 
occupent 	occupent 
occuper 	occuper 
occupera 	occupera 
occupÃ 	occupÃ 
occurrence 	occurrence 
octobre 	octobre 
ocÃ 	ocÃ 
odeur 	odeur
odeurs 	odeur
oeuvre 	oeuvre
oeuvres 	oeuvre
of 	of 
off 	off 
offertes 	offertes 
officiel 	officiel
officielle 	officielle
officiellement 	officielle
offre 	offre 
offrent 	offrent 
offres 	offres 
offrir 	offrir
offrira 	offrir
oh 	oh 
oiseaux 	oiseaux 
olfactive 	olfactive 
olive 	oliv
olivier 	oliv
omnt 	omnt 
omp 	omp 
oms 	oms 
one 	one 
onera 	onera 
onu 	onu 
onze 	onze 
opaline 	opaline 
ophtalmologie 	ophtalmologie 
opportun 	opportun
opportunitÃ 	opportun
opter 	opter 
optimisant 	optimis
optimisation 	optimis
optimiser 	optimis
optimiste 	optimis
optimisÃ 	optimis
optique 	optique
optiques 	optique
optÃ 	optÃ 
opÃ 	opÃ 
or 	or 
orbites 	orbites 
ordinateur 	ordinateur 
ordre 	ordre
ordres 	ordre
ores 	ores 
organe 	organ
organes 	organ
organique 	organ
organiques 	organ
organisait 	organ
organisateurs 	organ
organisation 	organ
organise 	organ
organisent 	organ
organiser 	organ
organismes 	organ
organisÃ 	organ
organoleptique 	organ
organoleptiques 	organ
orgue 	orgue 
orient 	orient
orientation 	orient
orientations 	orient
orientent 	orient
orienter 	orient
originaire 	origin
original 	origin
originale 	origin
originales 	origin
originalitÃ 	origin
origine 	origin
origines 	origin
orlÃ 	orlÃ 
oseo 	oseo 
osÃ 	osÃ 
oublier 	oublier 
ouest 	ouest 
oui 	oui 
outil 	outil
outils 	outil
outre 	outre 
ouvert 	ouvert
ouverte 	ouvert
ouvertes 	ouvert
ouverture 	ouvert
ouvrage 	ouvrage
ouvrages 	ouvrage
ouvrant 	ouvrant 
ouvre 	ouvre 
ouvrent 	ouvrent 
ouvriers 	ouvriers 
ouvrir 	ouvrir 
oxydants 	oxydants 
oxygÃ 	oxygÃ 
ozone 	ozone 
paca 	paca 
pacte 	pacte 
page 	page
pages 	page
pain 	pain 
palais 	palais
palaiseau 	palais
palette 	palette 
pallier 	pallier 
pam 	pam 
pancrÃ 	pancrÃ 
panne 	panne 
panoplie 	panoplie 
panorama 	panorama 
par 	par 
parallÃ 	parallÃ 
paraÃ 	paraÃ 
parc 	parc 
parce 	parce 
parcelle 	parcelle 
parcourir 	parcour
parcours 	parcour
parcouru 	parcour
pareil 	pareil 
parfait 	parfait
parfaitement 	parfait
parfaits 	parfait
parfois 	parfois 
pari 	pari 
parisienne 	parisienne 
parle 	parle
parlent 	parle
parler 	parle
parlera 	parle
parmi 	parmi 
parrain 	parrain 
part 	part 
partage 	partage 
partageant 	partageant 
partagent 	partagent 
partager 	partager 
partagÃ 	partagÃ 
partant 	partant 
partenaire 	partena
partenariat 	partenariat
partenariats 	partenariat
parti 	parti 
participait 	particip
participant 	participant
participantes 	participant
participants 	participant
participation 	particip
participe 	particip
participent 	particip
participer 	particip
participeront 	particip
participÃ 	particip
particularitÃ 	particul
particules 	particul
particuliers 	particul
particuliÃ 	particul
parties 	parties 
partout 	partout 
parts 	parts 
parvenir 	parven
parvenus 	parven
pas 	pas 
pascale 	pascale 
passage 	passage
passages 	passage
passant 	passant 
passe 	passe 
passer 	passer 
passif 	passif 
passion 	passion
passionnant 	passionnant
passionnantes 	passionnant
passÃ 	passÃ 
pathogÃ 	patho
pathologie 	pathologie
pathologies 	pathologie
patient 	patient
patients 	patient
patrimoine 	patrimoine 
paul 	paul 
pays 	pays
paysage 	pays
pc 	pc 
pcrd 	pcrd 
peau 	peau 
peine 	pein
peintures 	pein
pendant 	pendant 
pense 	pense 
penser 	penser 
pensons 	pensons 
pensÃ 	pensÃ 
perdent 	perdent 
perdre 	perdre 
perdu 	perdu 
perforation 	perfor
performance 	performance
performances 	performance
performant 	performan
performantes 	performan
performants 	performan
permanence 	permanen
permanents 	permanen
permettant 	permett
permette 	permett
permettra 	permett
permettrait 	permett
permettront 	permett
permÃ 	permÃ 
personnage 	personn
personnalisÃ 	personnali
personnalitÃ 	personnali
personne 	personn
personnel 	personn
personnels 	personn
personnes 	personn
perspective 	perspective
perspectives 	perspective
persuadÃ 	persuadÃ 
perte 	perte 
pertes 	pertes 
pertinence 	pertinen
pertinente 	pertinen
pertinents 	pertinen
perÃ 	perÃ 
pesant 	pesant 
peser 	peser 
pessimiste 	pessimiste 
pesÃ 	pesÃ 
petit 	petit
petite 	petit
petites 	petit
petits 	petit
peu 	peu 
peuplent 	peuplent 
peut 	peut 
ph 	ph 
phare 	phare 
phares 	phares 
pharmaceutique 	pharmac
pharmaceutiques 	pharmac
pharmacie 	pharmac
pharmaciens 	pharmac
pharmacologue 	pharmac
phase 	phase
phases 	phase
phenotyping 	phenotyping 
philosophe 	philosoph
philosophie 	philosoph
photo 	photo
photons 	photo
photosynthÃ 	photo
physical 	physi
physicien 	physi
physiciens 	physi
physico 	physi
physiologie 	physi
physiologique 	physi
physiologiques 	physi
physique 	physi
physiques 	physi
phÃ 	phÃ 
pied 	pied 
pierre 	pierre 
pilotage 	pilot
pilote 	pilot
piloter 	pilot
pilotes 	pilot
pilotÃ 	pilot
pionnier 	pionnier
pionniers 	pionnier
pire 	pire 
piste 	piste
pistes 	piste
pixels 	pixels 
piÃ 	piÃ 
placebo 	placebo 
placer 	placer 
placÃ 	placÃ 
plaines 	plaines 
plan 	plan 
plans 	plans 
plant 	plant 
plantÃ 	plantÃ 
planÃ 	planÃ 
plaques 	plaques 
plasticitÃ 	plast
plastique 	plastique
plastiques 	plastique
plasturgie 	plast
plate 	plate 
plateau 	plateau 
plateforme 	plateforme 
plats 	plats 
plein 	plein
pleine 	plein
pleinement 	plein
plos 	plos 
plupart 	plupart 
pluri 	pluri
pluridisciplinaire 	pluri
plusieurs 	plusieurs 
plutÃ 	plutÃ 
pme 	pme 
pmi 	pmi 
pnas 	pnas 
poche 	poche 
poids 	poids 
poignÃ 	poignÃ 
point 	point
pointe 	point
poisson 	poisson 
poitiers 	poitiers 
police 	police 
politique 	politique
politiques 	politique
polluants 	pollu
pollution 	pollu
pologne 	pologne 
polymÃ 	polymÃ 
polytechniciens 	polytechni
polytechnique 	polytechni
polyvalents 	polyvalents 
pont 	pont 
population 	population
populations 	population
poreux 	poreux 
port 	port 
portant 	portant 
porte 	porte 
portent 	portent 
porter 	porter 
portera 	portera 
porteront 	porteront 
portes 	portes 
porteur 	porteur 
porteurs 	porteurs 
porteuse 	porteuse 
portugal 	portugal 
portÃ 	portÃ 
pose 	pose 
posent 	posent 
poser 	poser 
positif 	positi
positifs 	positi
position 	positi
positionne 	positi
positionnement 	positi
positionner 	positi
positionnÃ 	positi
positive 	positi
possibilitÃ 	possib
possibles 	possib
possÃ 	possÃ 
post 	post 
poste 	poste 
posters 	posters 
postes 	postes 
posÃ 	posÃ 
potentialitÃ 	potenti
potentiel 	potentiel
potentiellement 	potentiel
potentielles 	potentiel
potentiels 	potentiel
pots 	pots 
poudres 	poudres 
pourquoi 	pourquoi 
pourra 	pourra 
pourraient 	pourraient 
pourrons 	pourron
pourront 	pourron
poursuit 	poursui
poursuivant 	poursui
poursuivent 	poursui
poursuivre 	poursui
pourtant 	pourtant 
poussant 	pouss
pousse 	pouss
pousser 	pouss
poussÃ 	pouss
pouvaient 	pouvaient 
pouvait 	pouvait 
pouvant 	pouvant 
pouvoir 	pouvoir
pouvoirs 	pouvoir
pouvons 	pouvons 
ppb 	ppb 
pratique 	pratique
pratiquement 	pratique
pratiquent 	pratique
pratiquer 	pratique
pratiques 	pratique
premier 	premier
premiers 	premier
premiÃ 	premi
prenant 	prenant 
prend 	prend 
prendra 	prendra 
prendre 	prendre 
prenez 	prenez 
prenne 	prenne
prennent 	prenne
pres 	pres 
presque 	presque 
presse 	presse 
pression 	pression 
prestations 	prestations 
prestigieuse 	prestigieu
prestigieux 	prestigieu
preuve 	preuve 
prides 	prides 
primaires 	primaires 
principal 	princip
principale 	princip
principalement 	princip
principales 	princip
principaux 	princip
principe 	princip
printemps 	printemps 
priori 	priori
prioritaires 	priori
prioritÃ 	priori
pris 	pris 
prise 	prise 
privilÃ 	privilÃ 
privÃ 	privÃ 
prix 	prix 
probablement 	probablement 
problÃ 	problÃ 
proceedings 	proceedings 
process 	process
processus 	process
prochain 	prochain
prochaine 	prochain
prochainement 	prochain
prochaines 	prochain
prochains 	prochain
proche 	proche 
proches 	proches 
procÃ 	procÃ 
producteur 	producteur
producteurs 	producteur
productif 	product
production 	production
productions 	production
productivitÃ 	product
produire 	produ
produisent 	produ
produit 	produ
produite 	produ
produites 	produ
produits 	produ
professeur 	professeur
professeurs 	professeur
professionnalisation 	professionnalis
professionnalisme 	professionnalis
professionnel 	professionnel
professionnelle 	professionnel
professionnelles 	professionnel
professionnels 	professionnel
profil 	profil 
profils 	profils 
profit 	profit 
profitent 	profitent 
profiter 	profiter 
profitÃ 	profitÃ 
profonde 	profond
profondeur 	profond
profondeurs 	profond
profonds 	profond
profondÃ 	profond
programme 	progr
programmes 	progr
progresser 	progr
progression 	progr
progressive 	progr
progrÃ 	progr
projet 	projet
projets 	projet
prolifÃ 	prolifÃ 
prolongement 	prolong
prolongÃ 	prolong
promesses 	promesses 
prometteur 	prometteu
prometteurs 	prometteu
prometteuse 	prometteuse
prometteuses 	prometteuse
promotion 	promotion 
promouvant 	promouv
promouvoir 	promouv
propagation 	propag
propager 	propag
propice 	propice 
proportion 	proportion 
propos 	propos 
proposant 	proposant 
propose 	propose 
proposent 	proposent 
proposer 	proposer 
proposera 	proposera 
proposons 	proposons 
proposÃ 	proposÃ 
propre 	propre 
propres 	propres 
propriÃ 	propriÃ 
propulseur 	propuls
propulsion 	propuls
prospectif 	prospecti
prospection 	prospecti
prospective 	prospecti
protection 	protection 
protein 	protein 
prothÃ 	prothÃ 
protocole 	protocole
protocoles 	protocole
prototypage 	prototyp
prototype 	prototyp
prototypes 	prototyp
protÃ 	protÃ 
prouver 	prouver 
provenance 	provenan
provenant 	provenan
proximitÃ 	proximitÃ 
prÃ 	prÃ 
prÃªt 	prÃªt
prÃªte 	prÃªt
prÃªts 	prÃªt
psychiatriques 	psych
psychologique 	psych
pu 	pu 
public 	publi
publication 	publi
publications 	publi
publics 	publi
publie 	publi
publient 	publi
publier 	publi
publique 	publi
publiÃ 	publi
puis 	puis
puisqu 	puis
puisque 	puis
puissante 	puis
puissantes 	puis
puissants 	puis
puisse 	puis
puissent 	puis
puissions 	puis
purement 	purement 
pÃ 	pÃ 
pÃªche 	pÃªche 
qu 	qu 
quae 	quae 
qualifier 	qualifi
qualifiÃ 	qualifi
qualitÃ 	quali
quand 	quand 
quant 	quant 
quantifier 	quantifier 
quantiques 	quantiques 
quantitative 	quantitative 
quantitÃ 	quantitÃ 
quarantaine 	quarantaine 
quasi 	quasi
quasiment 	quasi
quatre 	quatr
quatriÃ 	quatr
que 	que 
quel 	quel 
quelle 	quelle
quelles 	quelle
quelque 	quelque
quelques 	quelque
quels 	quels 
question 	question
questions 	question
quinzaine 	quinz
quinze 	quinz
quitter 	quitt
quittÃ 	quitt
quoi 	quoi 
quotidien 	quotidien
quotidienne 	quotidienne
quotidiennes 	quotidienne
quÃªte 	quÃªte 
radar 	radar
radars 	radar
radiation 	radiation
radiations 	radiation
radicalement 	radicalement 
raison 	raison 
ralentir 	ralenti
ralentissement 	ralenti
rang 	rang 
rapide 	rapide
rapidement 	rapide
rapides 	rapide
rappelant 	rappel
rappeler 	rappel
rappelons 	rappel
rapport 	rapport
rapports 	rapport
rapprochement 	rapproche
rapprocher 	rapproche
rare 	rare
rares 	rare
rassemblant 	rassembl
rassemble 	rassembl
rassembler 	rassembl
rassemblera 	rassembl
rassemblÃ 	rassembl
rassurer 	rass
rat 	rat 
rationaliser 	rationaliser 
rattachÃ 	rattachÃ 
rayonnement 	rayonnement 
re 	re 
reactor 	reactor 
recette 	recette 
recevoir 	recevoir 
recevront 	recevront 
rechercher 	recherch
recherches 	recherch
recherchÃ 	recherch
recommandations 	recommandations 
reconnaissance 	reconnaissan
reconnaissant 	reconnaissan
reconnaÃ 	reconnaÃ 
reconnu 	reconnu 
reconnue 	reconnue 
reconstruire 	reconstruire 
record 	record 
recourir 	recourir 
recours 	recours 
recouvre 	recouvre 
recrutement 	recrut
recrutÃ 	recrut
recueillies 	recueilli
recueillir 	recueilli
recul 	recul 
recyclage 	recyclage 
recÃ 	recÃ 
redonner 	redonner 
redressement 	redressement 
refrigeration 	refr
refroidir 	refr
regard 	regard
regarder 	regard
regrette 	regrette 
regroupant 	regroup
regroupe 	regroup
regroupement 	regroup
regroupÃ 	regroup
rein 	rein 
rejetÃ 	rejetÃ 
rejoindre 	rejoin
rejoint 	rejoin
relation 	relation
relations 	relation
relative 	relative
relativement 	relative
relatives 	relative
relever 	relev
relevÃ 	relev
relie 	relie 
relÃ 	relÃ 
remarquable 	remarquable
remarquables 	remarquable
rement 	rement 
remettre 	remettre 
remis 	remis
remise 	remis
remplacer 	rempl
remplir 	rempl
rencontre 	rencontr
rencontrer 	rencontr
rencontres 	rencontr
rencontrÃ 	rencontr
rend 	rend 
rendant 	rendant 
rendent 	rendent 
rendez 	rendez 
rendre 	rendre 
rendu 	rendu 
rendue 	rendue 
rendus 	rendus 
renfermant 	renferm
renferme 	renferm
renferment 	renferm
renforcement 	renforce
renforcer 	renforce
renforÃ 	renfor
renommÃ 	renommÃ 
renouvelable 	renouvel
renouvelables 	renouvel
renouveler 	renouvel
renouvellement 	renouvel
renseignements 	renseignements 
rentrÃ 	rentrÃ 
repose 	repose 
repris 	repris
reprises 	repris
reproduire 	reprodui
reproduit 	reprodui
reprÃ 	reprÃ 
research 	research 
respect 	respect
respectant 	respect
respectent 	respect
respecter 	respect
respectivement 	respect
responsabilitÃ 	responsab
responsable 	responsable
responsables 	responsable
ressemble 	ressemble 
ressource 	ressource
ressources 	ressource
restait 	restait 
restaurant 	restaur
restaurer 	restaur
reste 	reste 
restent 	restent 
rester 	rester 
restera 	restera 
restÃ 	restÃ 
retard 	retard 
retd 	retd 
retenue 	retenu
retenus 	retenu
retiendra 	retiendra 
retombÃ 	retombÃ 
retour 	retour
retours 	retour
retraite 	retraite 
retrouve 	retrouv
retrouver 	retrouv
retrouvÃ 	retrouv
revanche 	revanche 
review 	review 
revisiter 	revisiter 
revivre 	revivre 
revoir 	revoir 
revue 	revue
revues 	revue
revÃªtement 	revÃªtement 
reÃ 	reÃ 
rhÃ 	rhÃ 
riche 	riche
riches 	riche
richesse 	riche
rien 	rien 
risque 	risque
risques 	risque
robert 	robert 
roboticien 	robot
robotics 	robot
robotique 	robot
robots 	robot
robuste 	robuste
robustes 	robuste
roger 	roger 
romain 	romain 
ronde 	ronde
rondes 	ronde
rongeurs 	rongeurs 
roquette 	roquette 
rouges 	rouges 
roussillon 	roussillon 
route 	route
routes 	route
rude 	rude 
ruminants 	ruminants 
rupture 	rupture
ruptures 	rupture
russes 	russes 
rÃ 	rÃ 
sa 	sa 
sachant 	sachant 
saclay 	saclay 
sahara 	sahara 
sain 	sain 
saine 	saine 
saint 	saint 
saisie 	saisi
saisir 	saisi
sait 	sait 
salariÃ 	salariÃ 
salinitÃ 	salinitÃ 
salon 	salon
salons 	salon
sang 	sang 
sanguins 	sanguins 
sanitaire 	sanitaire
sanitaires 	sanitaire
sans 	sans 
santÃ 	santÃ 
saral 	saral 
sarcob 	sarcob 
satellitaires 	satellitaires 
satisfaction 	satisfa
satisfaire 	satisfa
satisfaisant 	satisfaisant
satisfaisante 	satisfaisant
satisfait 	satisfa
satisfaite 	satisfa
satisfaits 	satisfa
satt 	satt 
sauf 	sauf 
sauter 	sauter 
savait 	savait 
savent 	savent 
saveur 	saveur 
savions 	savions 
savoie 	savoie 
savoir 	savoir 
savons 	savons 
scale 	scale 
schiste 	schiste 
schneider 	schneider 
schÃ 	schÃ 
science 	science
sciences 	science
scientifique 	scientifique
scientifiquement 	scientifique
scientifiques 	scientifique
sclÃ 	sclÃ 
scolaire 	scolaire 
scorpions 	scorpions 
scrupuleusement 	scrupuleusement 
scÃ 	scÃ 
se 	se 
sec 	sec 
second 	second
secondaires 	second
secondes 	second
secours 	secours 
secrets 	secrets 
secrÃ 	secrÃ 
security 	security 
segalen 	segalen 
segment 	segment 
seins 	seins 
selon 	selon 
semaine 	semaine
semaines 	semaine
semblable 	sembl
semble 	sembl
semblent 	sembl
semblerait 	sembl
senior 	senior
seniors 	senior
sens 	sens 
sensibiliser 	sensibili
sensibilitÃ 	sensibili
sensible 	sensible
sensibles 	sensible
sensoriel 	sensoriel
sensorielles 	sensoriel
sensoriels 	sensoriel
sentinelles 	sentinelles 
septembre 	septembre 
sera 	sera 
seraient 	seraient 
serait 	serait 
serge 	serge 
seront 	seront 
serpents 	serpents 
serres 	serres 
sert 	sert 
servent 	servent 
servi 	servi 
service 	service
services 	service
servir 	servir 
ses 	ses 
sessions 	sessions 
seuil 	seuil 
seul 	seul 
seule 	seule 
seules 	seules 
seuls 	seuls 
sevrage 	sevrage 
shanghai 	shanghai 
shs 	shs 
signal 	sign
signature 	sign
signe 	sign
signer 	sign
significatif 	sign
significatifs 	sign
significative 	sign
significativement 	sign
significatives 	sign
signifie 	sign
signÃ 	sign
silencieux 	silencieux 
silice 	silic
silicium 	silic
silicon 	silic
similaire 	similaire
similaires 	similaire
simple 	simpl
simplement 	simpl
simples 	simpl
simplicitÃ 	simpl
simulation 	simul
simule 	simul
simuler 	simul
simultanÃ 	simul
singapour 	singapour 
singes 	singes 
sinon 	sinon 
sismologie 	sismologie 
site 	site 
sites 	sites 
situant 	situant 
situation 	situation
situations 	situation
situe 	situe 
situÃ 	situÃ 
six 	six 
siÃ 	siÃ 
smartphones 	smartphones 
sncf 	sncf 
snecma 	snecma 
social 	soci
sociale 	soci
sociales 	soci
sociaux 	soci
sociÃ 	soci
sodium 	sodium 
soient 	soient 
soigner 	soigner 
soins 	soins 
soixantaine 	soixantaine 
sol 	sol 
solaire 	solaire
solaires 	solaire
soldat 	soldat 
solidaire 	solid
solide 	solid
solidement 	solid
solides 	solid
sollicitÃ 	sollicitÃ 
solution 	solution
solutions 	solution
somme 	somme
sommeil 	somme
sommes 	somme
sommet 	somme
son 	son 
sonder 	sonder 
sophia 	sophi
sophistiquÃ 	sophi
sort 	sort
sorte 	sort
sortes 	sort
sortie 	sort
sortir 	sort
souci 	souci 
soudainement 	soudainement 
souffler 	souff
souffrant 	souff
souffrent 	souff
souhait 	souhait
souhaitant 	souhait
souhaite 	souhait
souhaitent 	souhait
souhaiter 	souhait
souhaiterions 	souhait
souhaitons 	souhait
souhaitÃ 	souhait
souligner 	soulign
soulignons 	soulign
soulignÃ 	soulign
soumettre 	soumettre 
soumis 	soumis 
souples 	souples
souplesse 	souples
source 	sourc
sources 	sourc
sourcÃ 	sourc
sous 	sous 
soutenir 	souten
soutenu 	souten
soutenue 	souten
soutenues 	souten
soutenus 	souten
soutiens 	soutien
soutient 	soutien
souvent 	souvent 
souvient 	souvient 
soyons 	soyons 
spatial 	spatial
spatiale 	spatial
spatiales 	spatial
spatio 	spati
spin 	spin 
spontanÃ 	spontanÃ 
sportifs 	sporti
sportives 	sporti
spot 	spot 
spÃ 	spÃ 
srl 	srl 
stabilitÃ 	stabilitÃ 
stables 	stables 
stade 	stade 
stages 	stages 
stand 	stand 
standards 	standards 
stands 	stands 
stanislas 	stanislas 
start 	start 
state 	state 
statistique 	statistique
statistiques 	statistique
steady 	steady 
stimulant 	stimulant 
stockage 	stock
stocker 	stock
stockÃ 	stock
strasbourg 	strasbourg 
stratÃ 	stratÃ 
structurales 	structur
structurant 	structur
structurants 	structur
structuration 	structur
structure 	structur
structurellement 	structur
structurer 	structur
structures 	structur
structurÃ 	structur
su 	su 
sub 	sub 
subir 	subir 
subissent 	subissent 
subsistent 	subsistent 
substances 	substances 
substitution 	substitution 
subtilement 	subtilement 
subvention 	subvention 
succession 	successi
successivement 	successive
successives 	successive
succÃ 	succ
sud 	sud 
suez 	suez 
suffisamment 	suffisa
suffisante 	suffisa
suffit 	suffi
suggÃ 	suggÃ 
suis 	suis 
suisse 	suisse 
suit 	suit 
suite 	suite 
suivant 	suivant
suivante 	suivant
suivantes 	suivant
suivi 	suivi 
suivis 	suivis 
suivre 	suivre 
sujet 	sujet
sujets 	sujet
supagro 	supagro 
superficie 	superficie 
supplÃ 	supplÃ 
support 	support 
suppose 	suppose 
supÃ 	supÃ 
sur 	sur 
surface 	surface
surfaces 	surface
surprenant 	surprenant 
surtout 	surtout 
surveillance 	surveill
surveiller 	surveill
survie 	survie 
survivre 	survivre 
susceptible 	susceptible 
suscite 	suscite
suscitent 	suscite
susciter 	suscite
sustainable 	sustainable 
suÃ 	suÃ 
swarm 	swarm 
sylvain 	sylvain 
symboliquement 	symboliquement 
synchrotron 	synchrotron 
synergie 	synergie 
synthÃ 	synthÃ 
systematic 	system
systems 	system
systÃ 	syst
sÃ 	sÃ 
t 	t 
table 	table
tableau 	table
tables 	table
tablettes 	table
tactiles 	tactiles 
taille 	taille 
talents 	talents 
tandis 	tandis 
tard 	tard 
targuer 	targuer 
taux 	taux 
te 	te 
techniciens 	techn
techniques 	techn
technolac 	technol
technologie 	technolog
technologies 	technolog
technologique 	technologique
technologiques 	technologique
technology 	technolog
tel 	tel 
telle 	telle
tellement 	telle
telles 	telle
tels 	tels 
temporelle 	temp
tempÃ 	temp
tendance 	tendance 
tendent 	tendent 
teneur 	teneur 
tenir 	tenir 
tension 	tension 
tentant 	tentant 
tentent 	tentent 
tenter 	tenter 
tentÃ 	tentÃ 
tenu 	tenu 
tenue 	tenue 
ter 	ter 
teratec 	teratec 
termes 	termes 
terminaux 	termin
terminer 	terminer
terminera 	terminer
terrain 	terrain 
terre 	terre 
terres 	terres 
terrestres 	terrestres 
territoire 	territoire
territoires 	territoire
territoriale 	territo
tester 	test
tests 	test
testÃ 	test
teuse 	teuse 
teux 	teux 
tex 	tex 
textile 	textile 
texture 	texture 
the 	the 
thermique 	thermique
thermiques 	thermique
thermonuclear 	therm
thÃ 	thÃ 
tic 	tic 
tiendra 	tien
tienne 	tien
tient 	tien
tir 	tir 
tirant 	tirant 
tirent 	tirent 
tirer 	tirer 
tissus 	tissus 
titane 	titane 
titre 	titre 
titulaires 	titulaires 
tolÃ 	tolÃ 
tonne 	tonne
tonnes 	tonne
topographie 	topographie 
totale 	totale
totalement 	totale
touchant 	touch
touche 	touch
touchent 	touch
toucher 	touch
toulousain 	toulousain
toulousaine 	toulousain
toulousains 	toulousain
toulouse 	toulous
tour 	tour 
tourisme 	tourisme 
tourne 	tourne 
tourner 	tourner 
tournesol 	tournesol 
tournÃ 	tournÃ 
tours 	tours 
tous 	tous 
tout 	tout 
toute 	toute 
toutefois 	toutefois 
toutes 	toutes 
toxicitÃ 	toxi
toxique 	toxique
toxiques 	toxique
tpe 	tpe 
tradition 	tradition
traditionnel 	traditionnel
traditionnels 	traditionnel
traduire 	tradui
traduit 	tradui
traduite 	tradui
trafic 	trafic 
train 	train 
trains 	trains 
traitance 	traitan
traitant 	traitan
traite 	traite 
traitement 	traitement 
traiter 	traiter 
traitera 	traitera 
traitÃ 	traitÃ 
transfert 	trans
transferts 	trans
transformer 	trans
transformÃ 	trans
transfÃ 	trans
transition 	trans
transmettre 	trans
transmission 	trans
transport 	trans
transportent 	trans
transporter 	trans
transports 	trans
transposable 	trans
transverses 	trans
travail 	travail
travaillaient 	travail
travaillait 	travail
travaillant 	travail
travaille 	travail
travaillent 	travail
travailler 	travail
travailleront 	travail
travaillons 	travail
travaillÃ 	travail
travers 	travers
traverser 	travers
traversÃ 	travers
traÃ 	traÃ 
trentaine 	trent
trente 	trent
trentenaire 	trent
tri 	tri 
triarylamines 	triarylamines 
trois 	trois
troisiÃ 	trois
tromper 	tromper 
trop 	trop 
trophÃ 	trophÃ 
tropiques 	tropiques 
trou 	trou 
troubles 	troubles 
trouve 	trouve 
trouvent 	trouvent 
trouver 	trouver 
trouverez 	trouverez 
trouvÃ 	trouvÃ 
trÃ 	trÃ 
ts 	ts 
tsunami 	tsunami 
tube 	tube 
tumeur 	tumeur 
tungsten 	tungsten 
tunisie 	tunisie 
tunnel 	tunnel 
turbine 	turbine 
tutelle 	tutelle 
types 	types 
tÃ 	tÃ 
tÃªte 	tÃªte
tÃªtes 	tÃªte
uc 	uc 
ultime 	ultime 
ultra 	ultra 
umr 	umr 
unes 	unes 
union 	union 
unique 	unique
uniquement 	unique
uniques 	unique
unis 	unis 
unitÃ 	unitÃ 
univers 	univers
universitaire 	universit
universitaires 	universit
university 	universit
universitÃ 	universit
uns 	uns 
up 	up 
upmc 	upmc 
urbain 	urbain
urbaine 	urbain
urgence 	urgen
urgent 	urgen
usage 	usage
usages 	usage
usine 	usine
usines 	usine
utile 	util
utilisable 	util
utilisant 	util
utilisateurs 	util
utilise 	util
utilisent 	util
utiliser 	util
utilisÃ 	util
utilitÃ 	util
utÃ 	utÃ 
uvsq 	uvsq 
vague 	vague 
vaisseaux 	vaisseaux 
val 	val 
valence 	valence 
valeur 	valeur
valeurs 	valeur
validation 	valid
valider 	valid
validitÃ 	valid
validÃ 	valid
vallÃ 	vallÃ 
valorisant 	valoris
valorisation 	valoris
valoriser 	valoris
valorisÃ 	valoris
valÃ 	valÃ 
var 	var 
variabilitÃ 	variab
variables 	variab
varie 	varie 
varier 	varier 
variÃ 	variÃ 
vaste 	vaste
vastes 	vaste
vaudra 	vaudra 
vaut 	vaut 
veille 	veille
veillet 	veille
venant 	venant 
vendanges 	vendanges 
vendu 	vendu 
vendus 	vendus 
venez 	venez 
venir 	venir 
venons 	venons 
ventes 	ventes 
vents 	vents 
venu 	venu 
venus 	venus 
verre 	verre 
verres 	verres 
verront 	verront 
vers 	vers 
version 	version 
vert 	vert 
vertes 	vertes 
vertical 	vertical 
vertueux 	vertueux 
vertus 	vertus 
veut 	veut 
veux 	veux 
vi 	vi 
via 	via 
viable 	viable 
viande 	viande 
vibration 	vibration 
vice 	vice 
victimes 	victimes 
vidÃ 	vidÃ 
vie 	vie 
vieillissement 	vieillissement 
viendront 	viendront 
vient 	vient 
village 	vill
ville 	vill
villes 	vill
vin 	vin 
vingt 	vingt
vingtaine 	vingt
vinification 	vinification 
violents 	violents 
virtuellement 	virtuelle
virtuelles 	virtuelle
visant 	visant 
vise 	vise 
visent 	visent 
visibilitÃ 	visibilitÃ 
visible 	visible
visiblement 	visible
vision 	vision 
visite 	visite
visites 	visite
visiteurs 	visite
visualiser 	visualiser 
visuelle 	visuelle 
visÃ 	visÃ 
vit 	vit 
vitagora 	vitagora 
vite 	vite 
vitesse 	vitesse
vitesses 	vitesse
viticole 	viticole
viticoles 	viticole
viticulture 	vitic
vitro 	vitro 
vivante 	vivante 
vivent 	vivent 
viveris 	viveris 
vivo 	vivo 
vivre 	vivre 
vocation 	vocation 
voie 	voie 
voies 	voies 
voile 	voile 
voilier 	voilier 
voilÃ 	voilÃ 
voir 	voir 
voit 	voit 
vol 	vol 
volant 	volant 
volent 	volent 
voler 	voler 
volet 	volet 
volontairement 	volontaire
volontaires 	volontaire
volontÃ 	volont
vols 	vols 
vos 	vos 
vouloir 	vouloir 
voulu 	voulu 
vous 	vous 
voyager 	voyage
voyageurs 	voyage
vrai 	vrai
vraie 	vrai
vraiment 	vrai
vrais 	vrai
vu 	vu 
vue 	vue 
vulnÃ 	vulnÃ 
vÃ 	vÃ 
vÃªtements 	vÃªtements 
water 	water 
www 	www 
xix 	xix 
xixÃ 	xixÃ 
xxiÃ 	xxiÃ 
xxÃ 	xxÃ 
yvette 	yvette 
zone 	zone 
zÃ 	zÃ 
 application 	 app
 apport 	 app
 approche 	 app
 belle 	 belle 
 bons 	 bons 
 caractÃ 	 caractÃ 
 chez 	 chez 
 comprend 	 comp
 comptent 	 comp
 connus 	 connus 
 contrastÃ 	 contrastÃ 
 destination 	 destination 
 envisager 	 envisager 
 forme 	 forme 
 frontiÃ 	 frontiÃ 
 groupe 	 groupe 
 impliquÃ 	 impliquÃ 
 intÃ 	 intÃ 
 menÃ 	 menÃ 
 naturels 	 naturels 
 nos 	 nos 
 obtenir 	 obtenir 
 osÃ 	 osÃ 
 ouverture 	 ouverture 
 pays 	 pays 
 performances 	 performances 
 plupart 	 plupart 
 publication 	 publication 
 purement 	 purement 
 rÃ 	 rÃ 
 services 	 services 
 seuls 	 seuls 
 structures 	 structures 
 succÃ 	 succÃ 
 tonnes 	 tonnes 
 transport 	 transport 
 utilisÃ 	 utilisÃ 
 Ã 	 Ã 
¢ce 	¢ce 
¢che 	¢che
¢ches 	¢che
¢ge 	¢ge 
¢ges 	¢ges 
¢gÃ 	¢gÃ 
¢me 	¢me 
¢teau 	¢teau 
¢ti 	¢ti 
¢timent 	¢timent
¢timents 	¢timent
¢tir 	¢tir 
¢ts 	¢ts 
§a 	§a 
§abilitÃ 	§abilitÃ 
§age 	§age 
§ais 	§ais
§aise 	§ais
§aises 	§ais
§ant 	§ant 
§oit 	§oit 
§oivent 	§oivent 
§ons 	§ons 
§u 	§u 
§ue 	§ue 
§ues 	§ues 
§us 	§us 
¨bre 	¨bre 
¨ce 	¨ce 
¨ces 	¨ces 
¨cle 	¨cle 
¨de 	¨de 
¨dent 	¨dent 
¨ge 	¨ge 
¨gle 	¨gle 
¨gre 	¨gre 
¨gue 	¨gue
¨gues 	¨gue
¨le 	¨le 
¨lement 	¨lement 
¨lent 	¨lent 
¨les 	¨les 
¨me 	¨me 
¨mes 	¨mes 
¨ne 	¨ne 
¨nent 	¨nent 
¨nes 	¨nes 
¨que 	¨que 
¨re 	¨re 
¨rement 	¨rement 
¨rent 	¨rent 
¨res 	¨res 
¨retÃ 	¨retÃ 
¨s 	¨s 
¨se 	¨se 
¨ses 	¨ses 
¨te 	¨te 
¨tement 	¨tement 
¨tes 	¨tes 
¨tre 	¨tre
¨tres 	¨tre
¨ve 	¨ve 
¨vement 	¨vement
¨vements 	¨vement
¨vera 	¨vera 
¨ves 	¨ves 
©able 	©able 
©abondante 	©abondante 
©aborder 	©aborder 
©aboutir 	©aboutir 
©abrite 	©abrite 
©absorber 	©absor
©absorption 	©absor
©acadÃ 	©acadÃ 
©accompagne 	©accompagn
©accompagner 	©accompagn
©accompagnÃ 	©accompagn
©accord 	©accord
©accords 	©accord
©accroÃ 	©accroÃ 
©accÃ 	©accÃ 
©acheter 	©acheter 
©acides 	©acides 
©acteur 	©acteur
©acteurs 	©acteur
©actifs 	©actifs 
©action 	©action
©actions 	©action
©activement 	©activement 
©activitÃ 	©activitÃ 
©actuelle 	©actuelle 
©adaptation 	©adapt
©adaptÃ 	©adapt
©additifs 	©additifs 
©adhÃ 	©adhÃ 
©adultes 	©adultes 
©agence 	©agence 
©agir 	©agir 
©agissait 	©agiss
©agissent 	©agiss
©agricole 	©agricole
©agricoles 	©agricole
©agronov 	©agronov 
©ai 	©ai 
©aide 	©aide
©aider 	©aide
©aire 	©aire 
©ajoute 	©ajoute
©ajouter 	©ajoute
©al 	©al 
©alablement 	©alablement 
©ales 	©ales 
©alimentaire 	©aliment
©alimentation 	©aliment
©alimente 	©aliment
©alisant 	©alisant 
©alisation 	©alisation
©alisations 	©alisation
©alise 	©alise 
©alisent 	©alisent 
©alisons 	©alisons 
©aliste 	©aliste
©alistes 	©aliste
©alisÃ 	©alisÃ 
©alitÃ 	©alitÃ 
©allait 	©allait 
©aller 	©aller 
©alliance 	©alliance 
©alors 	©alors 
©ambition 	©ambition 
©amenÃ 	©amenÃ 
©american 	©american 
©ampleur 	©ampl
©amplification 	©ampl
©amÃ 	©amÃ 
©an 	©an 
©analyse 	©analyse 
©anciens 	©anciens 
©and 	©and 
©aniques 	©aniques 
©anmoins 	©anmoins 
©annonce 	©annonc
©annoncÃ 	©annonc
©anographique 	©anographique
©anographiques 	©anographique
©ans 	©ans 
©ant 	©ant 
©apparition 	©app
©appel 	©app
©appellation 	©app
©appelle 	©app
©application 	©app
©appliquant 	©app
©appliquÃ 	©app
©apporter 	©app
©apprentissage 	©app
©appris 	©app
©approche 	©app
©approches 	©app
©appuyer 	©app
©architecture 	©architecture 
©argent 	©argent 
©arnaud 	©arnaud 
©arrivent 	©arrivent 
©article 	©article
©articles 	©article
©articule 	©artic
©as 	©as 
©aspect 	©aspect 
©assembler 	©assembler 
©assister 	©assister 
©associer 	©associ
©associÃ 	©associ
©assurer 	©assurer 
©astrophysique 	©astrophysique 
©at 	©at 
©atelier 	©atelier 
©ates 	©ates 
©ateur 	©ateur
©ateurs 	©ateur
©atif 	©atif 
©atifs 	©atifs 
©ation 	©ation 
©atiques 	©atiques 
©ativitÃ 	©ativitÃ 
©attaquer 	©attaquer 
©attirer 	©attirer 
©au 	©au 
©aucun 	©aucun 
©augmentation 	©augmentation 
©auprÃ 	©auprÃ 
©aura 	©aura
©aurait 	©aura
©aussitÃ 	©aussitÃ 
©autant 	©autant 
©automne 	©automne 
©automobile 	©automobile 
©autoroute 	©autoroute 
©autre 	©autre
©autrement 	©autre
©auxquels 	©auxquels 
©avaient 	©avaient 
©avait 	©avait 
©avancÃ 	©avancÃ 
©avantage 	©avantage 
©avec 	©avec 
©avenir 	©avenir 
©aviation 	©aviation 
©avionneur 	©avion
©avions 	©avion
©avis 	©avis 
©avons 	©avons 
©avril 	©avril 
©axes 	©axes 
©aÃ 	©aÃ 
©bac 	©bac 
©baptisÃ 	©baptisÃ 
©bas 	©bas 
©base 	©base 
©basse 	©basse
©basses 	©basse
©basÃ 	©basÃ 
©bat 	©bat 
©bateaux 	©bateaux 
©bats 	©bats 
©battre 	©battre 
©bauche 	©bauche 
©beaucoup 	©beaucoup 
©bel 	©bel 
©belles 	©belles 
©benjamin 	©benjamin 
©bergÃ 	©bergÃ 
©bernard 	©bernard 
©besoin 	©besoin 
©bientÃ 	©bientÃ 
©bilan 	©bilan 
©biodiversitÃ 	©biodiversitÃ 
©biologie 	©biologi
©biologique 	©biologi
©bit 	©bit 
©bon 	©bon 
©bord 	©bord
©bordeaux 	©bord
©boucher 	©boucher 
©bouclÃ 	©bouclÃ 
©bourgogne 	©bourgogne 
©bout 	©bout 
©brale 	©brale
©brales 	©brale
©bras 	©bras 
©brer 	©brer 
©brevet 	©brevet
©brevets 	©brevet
©brevetÃ 	©brevet
©brillamment 	©brillamment 
©brio 	©brio 
©bruxelles 	©bruxelles 
©busquer 	©busquer 
©but 	©but 
©bute 	©bute 
©butÃ 	©butÃ 
©bÃ 	©bÃ 
©calcium 	©calcium 
©camÃ 	©camÃ 
©canada 	©canada 
©canique 	©canique
©caniques 	©canique
©canisme 	©canisme
©canismes 	©canisme
©capable 	©capable 
©capacitÃ 	©capacitÃ 
©capital 	©capital 
©car 	©car 
©caractÃ 	©caractÃ 
©carbone 	©carbon
©carbonÃ 	©carbon
©carriÃ 	©carriÃ 
©cas 	©cas 
©cea 	©cea 
©ceci 	©ceci 
©celle 	©celle 
©celles 	©celles 
©cellule 	©cellule
©cellules 	©cellule
©celui 	©celui 
©cembre 	©cembre 
©cemment 	©cemment 
©cennie 	©cennie
©cennies 	©cennie
©cente 	©cente 
©centes 	©centes 
©centrale 	©centrale 
©centre 	©centre 
©centrÃ 	©centrÃ 
©cepteur 	©cept
©ception 	©cept
©cernÃ 	©cernÃ 
©certain 	©certain
©certaine 	©certain
©certains 	©certain
©certes 	©certes 
©cerveau 	©cerveau 
©cessairement 	©cess
©cessitant 	©cessit
©cessite 	©cessit
©cessitent 	©cessit
©cessitÃ 	©cessit
©cet 	©cet 
©cgns 	©cgns 
©chacun 	©chacun 
©chaleur 	©chaleur 
©challenge 	©challenge 
©chambre 	©chambre 
©champ 	©champ 
©champs 	©champs 
©change 	©change
©changer 	©change
©changes 	©change
©chantillonnage 	©chantillon
©chantillons 	©chantillon
©chaque 	©chaque 
©chargÃ 	©chargÃ 
©chaÃ 	©chaÃ 
©checs 	©checs 
©chef 	©chef 
©chelle 	©chelle
©chelles 	©chelle
©chemin 	©chemin 
©cherche 	©cherche
©chercheur 	©cherche
©chez 	©chez 
©chiffre 	©chiffre 
©chimie 	©chimi
©chimique 	©chimi
©chir 	©chir 
©chissant 	©chiss
©chissent 	©chiss
©chissons 	©chiss
©chit 	©chit 
©choisis 	©choi
©choix 	©choi
©cial 	©cial
©cialiste 	©cialiste
©cialistes 	©cialiste
©cialisÃ 	©cial
©cialitÃ 	©cial
©cible 	©cible 
©cide 	©cide 
©cider 	©cider 
©cideurs 	©cideurs 
©cidÃ 	©cidÃ 
©ciel 	©ciel 
©cier 	©cier 
©cieux 	©cieux 
©cificitÃ 	©cifi
©cifique 	©cifique
©cifiquement 	©cifique
©cifiques 	©cifique
©cinquiÃ 	©cinquiÃ 
©cirad 	©cirad 
©circulation 	©circulation 
©cis 	©cis 
©cision 	©cision
©cisions 	©cision
©cisÃ 	©cisÃ 
©citoyen 	©citoyen 
©civil 	©civil
©civile 	©civil
©clairage 	©clairage 
©clarent 	©clarent 
©clarer 	©clarer 
©clarÃ 	©clarÃ 
©classique 	©classique
©classiques 	©classique
©clencher 	©clencher 
©clients 	©clients 
©climat 	©climat
©climatique 	©climat
©climats 	©climat
©clinique 	©clinique
©cliniques 	©clinique
©clore 	©clore 
©clÃ 	©clÃ 
©co 	©co 
©coces 	©coces 
©codes 	©codes 
©coeur 	©coeur 
©coles 	©coles 
©collaborations 	©collaborations 
©colloque 	©colloque 
©collÃ 	©collÃ 
©cologie 	©cologi
©cologique 	©cologique
©cologiques 	©cologique
©colonne 	©colonne 
©colte 	©colte
©coltes 	©colte
©combiner 	©combiner 
©comitÃ 	©comitÃ 
©commence 	©commence 
©commencer 	©commencer 
©commencÃ 	©commencÃ 
©comment 	©comment 
©commerciale 	©commercial
©commercialisation 	©commercialis
©commercialiser 	©commercialis
©commission 	©commission 
©communautÃ 	©commun
©commune 	©commun
©compagnon 	©compagnon 
©comparer 	©comparer 
©comparÃ 	©comparÃ 
©compense 	©compens
©compensÃ 	©compens
©complÃ 	©complÃ 
©comporte 	©comporte 
©composÃ 	©composÃ 
©comprendre 	©comprendre 
©compÃ 	©compÃ 
©concentration 	©concentration 
©concept 	©concept
©conception 	©concept
©concernant 	©concernant 
©concevoir 	©concevoir 
©conclut 	©conclut 
©concourir 	©concour
©concours 	©concour
©conditions 	©conditions 
©conducteur 	©conducteur 
©conduire 	©conduire 
©confiÃ 	©confiÃ 
©confÃ 	©confÃ 
©conjointement 	©conjointement 
©connaissons 	©connaissons 
©conomie 	©conomi
©conomique 	©conomique
©conomiquement 	©conomique
©conomiques 	©conomique
©conomiste 	©conomi
©conomistes 	©conomi
©consacrÃ 	©consacrÃ 
©conseil 	©conseil 
©conserver 	©conserver 
©consommateur 	©consomm
©consommation 	©consomm
©consomme 	©consomm
©consomment 	©consomm
©consommÃ 	©consomm
©consortium 	©consortium 
©constat 	©constat
©constate 	©constat
©constitue 	©constitu
©constituÃ 	©constitu
©constructeur 	©construct
©construction 	©construct
©consÃ 	©consÃ 
©contact 	©contact 
©contient 	©contient 
©continuer 	©continuer 
©contraintes 	©contraintes 
©contrat 	©contrat 
©contrats 	©contrats 
©contre 	©contre 
©contrÃ 	©contrÃ 
©convaincu 	©convaincu 
©conÃ 	©conÃ 
©coopÃ 	©coopÃ 
©coordonner 	©coordonn
©coordonnÃ 	©coordonn
©cor 	©cor 
©cortiquer 	©cortiquer 
©cosystÃ 	©cosystÃ 
©coulisses 	©coulisses 
©coup 	©coup 
©couper 	©couper 
©courant 	©courant
©courante 	©courant
©course 	©course 
©coute 	©coute
©couter 	©coute
©couvert 	©couvert
©couverte 	©couvert
©couvertes 	©couvert
©couvre 	©couvre 
©couvrir 	©couvrir 
©coÃ 	©coÃ 
©cresse 	©cresse 
©crire 	©crire 
©crit 	©crit 
©criture 	©criture 
©critÃ 	©critÃ 
©crivent 	©crivent 
©crocher 	©croch
©crochÃ 	©croch
©croissance 	©croissan
©croissante 	©croissan
©croÃ 	©croÃ 
©crÃ 	©crÃ 
©cu 	©cu 
©cube 	©cube 
©culaire 	©culaire
©culaires 	©culaire
©cule 	©cule 
©cules 	©cules 
©culturale 	©cultur
©culture 	©cultur
©curiositÃ 	©curi
©curisation 	©curi
©curiser 	©curi
©curitÃ 	©curi
©cuter 	©cuter 
©cycles 	©cycles 
©cÃ 	©cÃ 
©dagogie 	©dagogi
©dagogique 	©dagogi
©daille 	©daille 
©dant 	©dant 
©davantage 	©davantage 
©decin 	©decin
©decine 	©decin
©decins 	©decin
©delÃ 	©delÃ 
©demment 	©demment 
©dent 	©dent
©dente 	©dent
©dentes 	©dent
©depuis 	©depuis 
©der 	©der 
©dermatologie 	©dermatologie 
©derniers 	©derni
©derniÃ 	©derni
©design 	©design 
©dessiner 	©dessiner 
©destination 	©destination 
©destruction 	©destruction 
©deux 	©deux
©deuxiÃ 	©deux
©devant 	©devant 
©devenues 	©devenues 
©devient 	©devient 
©devons 	©devons 
©devraient 	©devraient 
©diagnostic 	©diagnostic 
©diaire 	©diaire
©diaires 	©diaire
©diane 	©diane 
©dias 	©dias 
©diat 	©diat 
©diates 	©diates 
©dible 	©dible 
©dical 	©dical 
©dicale 	©dicale 
©dicament 	©dicament
©dicaments 	©dicament
©dicaux 	©dicaux 
©diction 	©diction 
©dients 	©dients 
©difficile 	©diff
©difficultÃ 	©diff
©diffusion 	©diff
©diffÃ 	©diff
©dijon 	©dijon
©dijonnaise 	©dijon
©dimension 	©dimension 
©diminuer 	©diminu
©diminution 	©diminu
©dire 	©dire 
©direct 	©direct
©directement 	©direct
©directeur 	©direct
©direction 	©direct
©directions 	©direct
©directrice 	©direct
©dirige 	©dirige 
©discipline 	©discipline 
©dispenser 	©dispenser 
©disponible 	©disponible 
©dispose 	©dispose 
©disposer 	©disposer 
©dispositif 	©dispositi
©dispositifs 	©dispositi
©disposition 	©dispositi
©distance 	©distance 
©distribution 	©distribution 
©dit 	©dit 
©dite 	©dite 
©diter 	©diter 
©diterranÃ 	©diterranÃ 
©ditions 	©ditions 
©dix 	©dix 
©dizaine 	©dizaine 
©diÃ 	©diÃ 
©doctorat 	©doctorat 
©doit 	©doit 
©doivent 	©doivent 
©donnÃ 	©donnÃ 
©doute 	©doute 
©droit 	©droit 
©ducation 	©ducation 
©duire 	©duire 
©duit 	©duit 
©duite 	©duite 
©durable 	©durable 
©durÃ 	©durÃ 
©dynamique 	©dynamique 
©dÃ 	©dÃ 
©e 	©e 
©eau 	©eau
©eaux 	©eau
©ecole 	©eco
©economie 	©eco
©editeur 	©edit
©editions 	©edit
©effectifs 	©effect
©effectuÃ 	©effect
©effets 	©eff
©efficacitÃ 	©eff
©el 	©el 
©elle 	©elle
©ellement 	©elle
©elles 	©elle
©els 	©els 
©embauche 	©embauche
©embaucher 	©embauche
©emblÃ 	©emblÃ 
©emm 	©emm 
©emplois 	©emplois 
©en 	©en 
©energy 	©energy 
©enfermer 	©enfermer 
©enjeux 	©enjeux 
©enne 	©enne
©ennes 	©enne
©enquÃªte 	©enquÃªte 
©ens 	©ens 
©enseignants 	©enseign
©enseignement 	©enseignement
©enseignements 	©enseignement
©ensuite 	©ensuite 
©ent 	©ent 
©entamer 	©entamer 
©enthousiasme 	©enthousiasme 
©entier 	©entier 
©entitÃ 	©entitÃ 
©entraÃ 	©entraÃ 
©entre 	©entre 
©entreprise 	©entreprise
©entreprises 	©entreprise
©entrÃ 	©entrÃ 
©enveloppe 	©enveloppe 
©environ 	©environ
©environnement 	©environnement
©environnemental 	©environnemental
©environnementale 	©environnemental
©envisageable 	©envisageable 
©equateur 	©equateur 
©er 	©er 
©es 	©es 
©espace 	©espace 
©espÃ 	©espÃ 
©esquisser 	©esquisser 
©essai 	©essai 
©essentiel 	©essentiel
©essentiellement 	©essentiel
©etat 	©etat
©etats 	©etat
©etudes 	©etudes 
©europÃ 	©euro
©euros 	©euro
©eux 	©eux 
©excellence 	©exce
©exceptionnelle 	©exce
©executive 	©executive 
©exemplaires 	©exemplaires 
©exercice 	©exercice 
©existait 	©exist
©existe 	©exist
©expert 	©expert
©experts 	©expert
©expliquÃ 	©expliquÃ 
©exploitation 	©exploitation 
©explorer 	©explorer 
©exposants 	©expos
©expose 	©expos
©expÃ 	©expÃ 
©extia 	©extia 
©extraire 	©extraire 
©extrÃªmes 	©extrÃªmes 
©fabricants 	©fabrica
©fabrication 	©fabrica
©fabriquer 	©fabri
©face 	©face 
©facilement 	©facilement 
©facteurs 	©facteurs 
©facÃ 	©facÃ 
©faible 	©faible 
©faisant 	©faisant 
©falloir 	©falloir 
©famille 	©famille 
©faudrait 	©faudrait 
©faut 	©faut 
©favoriser 	©favoriser 
©fendre 	©fendre 
©ferme 	©ferme 
©fi 	©fi 
©fiable 	©fiable 
©fice 	©fice 
©fices 	©fices 
©ficie 	©ficie 
©ficient 	©ficient 
©ficier 	©ficier 
©ficieront 	©ficieront 
©ficits 	©ficits 
©ficiÃ 	©ficiÃ 
©filiale 	©fili
©filiÃ 	©fili
©final 	©final 
©finale 	©finale 
©financements 	©financ
©financÃ 	©financ
©fini 	©fini 
©finie 	©finie 
©finies 	©finies 
©finir 	©finir 
©finit 	©finit 
©finition 	©finition 
©fis 	©fis 
©fixes 	©fixes 
©flexion 	©flexion
©flexions 	©flexion
©flux 	©flux 
©flÃ 	©flÃ 
©focus 	©focus 
©fonctionnement 	©fonctionne
©fonctionner 	©fonctionne
©fond 	©fond 
©fondamentale 	©fondamentale 
©fondateurs 	©fondateurs 
©fondation 	©fondation 
©fonds 	©fonds 
©force 	©force 
©formant 	©formant 
©formation 	©formation 
©forme 	©forme 
©fort 	©fort 
©forte 	©forte 
©fortes 	©fortes 
©forum 	©forum 
©fourni 	©fourni
©fournir 	©fourni
©fourniture 	©fourni
©franche 	©fran
©franchir 	©fran
©franco 	©fran
©franÃ 	©fran
©frigÃ 	©frigÃ 
©fruit 	©fruit 
©fui 	©fui 
©futur 	©futur
©futurs 	©futur
©fÃ 	©fÃ 
©ga 	©ga 
©gale 	©gale 
©gamme 	©gamme 
©garantie 	©garanti
©garantit 	©garanti
©gastro 	©gastro 
©gative 	©gative 
©gens 	©gens 
©ger 	©ger 
©gestion 	©gestion 
©gide 	©gide 
©gie 	©gie 
©gies 	©gies 
©gigantesque 	©gigantesque 
©gime 	©gime
©gimes 	©gime
©gion 	©gion
©gional 	©gion
©gionale 	©gion
©gionales 	©gion
©gionaux 	©gion
©gions 	©gion
©gique 	©gique
©giques 	©gique
©gitime 	©gitime 
©giÃ 	©giÃ 
©glage 	©glage 
©glementaires 	©glementa
©glementations 	©glementa
©gler 	©gler 
©gligeable 	©glige
©gliger 	©glige
©global 	©global
©globale 	©global
©gories 	©gories 
©goÃ 	©goÃ 
©gradent 	©gradent 
©grande 	©grande 
©grandir 	©grandir 
©grant 	©grant 
©grateur 	©grateur 
©grenelle 	©grenelle 
©grenoble 	©grenoble 
©grer 	©grer 
©gros 	©gros 
©groupe 	©groupe
©groupement 	©groupe
©groupes 	©groupe
©grÃ 	©grÃ 
©gulation 	©gulation 
©gulent 	©gulent 
©guliers 	©guliers 
©guliÃ 	©guliÃ 
©gumineuses 	©gumineuses 
©guyane 	©guyane 
©guÃ 	©guÃ 
©gÃ 	©gÃ 
©habilitation 	©habi
©habitat 	©habi
©haut 	©haut
©haute 	©haut
©hauteur 	©haut
©hender 	©hen
©hension 	©hen
©hicules 	©hicules 
©historique 	©historique 
©homme 	©homme
©hommes 	©homme
©honneur 	©honneur 
©hospitalier 	©hospitalier 
©humaine 	©hum
©humanoÃ 	©hum
©humiditÃ 	©hum
©hÃ 	©hÃ 
©ici 	©ici 
©idÃ 	©idÃ 
©ile 	©ile 
©illustre 	©illustre
©illustrer 	©illustre
©ils 	©ils 
©imager 	©imager 
©impact 	©impact 
©implantation 	©implantation 
©implique 	©impliqu
©impliquer 	©impliqu
©impliquÃ 	©impliqu
©importance 	©importance 
©in 	©in 
©inaugurÃ 	©inaugurÃ 
©incontestable 	©incontestable 
©incubateur 	©incubateur 
©indiquer 	©indiquer 
©industrialisation 	©industrialis
©industrialisÃ 	©industrialis
©industrie 	©industri
©industriel 	©industri
©industrielle 	©industri
©ines 	©ines 
©influencer 	©influencer 
©informatique 	©informatique 
©ingÃ 	©ingÃ 
©initiative 	©initiative 
©injecter 	©injecter 
©innovant 	©innov
©innovation 	©innovation
©innovations 	©innovation
©innover 	©innov
©inra 	©inra 
©inscrit 	©inscrit
©inscrite 	©inscrit
©inserm 	©inserm 
©institute 	©institut
©institutions 	©institut
©intellectuelle 	©intell
©intelligence 	©intell
©intermÃ 	©intermÃ 
©international 	©international
©internationale 	©international
©internationales 	©international
©interne 	©interne 
©internet 	©internet 
©interroge 	©interroge 
©interventions 	©interventions 
©intitulÃ 	©intitulÃ 
©intrinsÃ 	©intrinsÃ 
©introduit 	©introduit 
©intÃ 	©intÃ 
©inverse 	©inve
©investir 	©investi
©investissements 	©investi
©inÃ 	©inÃ 
©isme 	©isme 
©italie 	©italie 
©itÃ 	©itÃ 
©jacques 	©jacques 
©jambes 	©jambes 
©janvier 	©janvier 
©japon 	©japon 
©je 	©je 
©jean 	©jean 
©jeune 	©jeune 
©joue 	©jou
©jouer 	©jou
©jouit 	©jou
©jour 	©jou
©journÃ 	©jou
©juillet 	©juillet 
©juin 	©juin 
©juste 	©juste 
©jÃ 	©jÃ 
©kg 	©kg 
©kourou 	©kourou 
©labellisÃ 	©labellisÃ 
©laboration 	©laborat
©laboratoire 	©laborat
©laborer 	©labor
©lais 	©lais 
©laisser 	©laisser 
©laissÃ 	©laissÃ 
©lait 	©lait 
©lan 	©lan 
©lance 	©lance 
©lancement 	©lancement 
©lancer 	©lancer 
©lancÃ 	©lancÃ 
©lande 	©lande 
©lange 	©lange 
©langÃ 	©langÃ 
©largir 	©largir 
©las 	©las 
©laser 	©laser 
©laurÃ 	©laurÃ 
©leader 	©leader 
©lecteurs 	©lect
©lectif 	©lect
©lection 	©lect
©lectionner 	©lect
©lectionnÃ 	©lect
©lectricitÃ 	©lect
©lectrique 	©lect
©lectriques 	©lect
©lectronique 	©lect
©lectroniques 	©lect
©lesquelles 	©lesquel
©lesquels 	©lesquel
©leurre 	©leurre 
©levages 	©levages 
©levÃ 	©levÃ 
©libÃ 	©libÃ 
©licite 	©licit
©licitÃ 	©licit
©licoptÃ 	©licoptÃ 
©lien 	©lien 
©liens 	©liens 
©lieu 	©lieu 
©liminer 	©liminer 
©lioration 	©lioration 
©liorer 	©liorer 
©liosynchrone 	©liosynchrone 
©liquide 	©liquide 
©lisation 	©lisation 
©liser 	©liser 
©lithium 	©lithium 
©livrer 	©livr
©livrÃ 	©livr
©liÃ 	©liÃ 
©local 	©loca
©localiser 	©loca
©locaux 	©loca
©logiciels 	©logiciels 
©loignÃ 	©loignÃ 
©loin 	©loin 
©loisirs 	©loisirs 
©longue 	©longue 
©lorsqu 	©lorsqu 
©luctable 	©luctable 
©ludwik 	©ludwik 
©lui 	©lui 
©lumiÃ 	©lumiÃ 
©lus 	©lus 
©lutter 	©lutter 
©lycÃ 	©lycÃ 
©lyon 	©lyon 
©lÃ 	©lÃ 
©ma 	©ma 
©magnÃ 	©magnÃ 
©main 	©main
©maintenant 	©mainten
©maintenir 	©mainten
©majeure 	©majeure
©majeures 	©majeure
©majoritÃ 	©majoritÃ 
©mal 	©mal 
©maladies 	©maladies 
©management 	©management 
©manque 	©manque 
©maquette 	©maquette 
©marchandises 	©march
©marches 	©march
©marchÃ 	©march
©marie 	©marie 
©marrage 	©marrage 
©marre 	©marre 
©marrÃ 	©marrÃ 
©mars 	©mars 
©mas 	©mas 
©massif 	©massif 
©maticiens 	©maticiens 
©matique 	©matique
©matiques 	©matique
©matiÃ 	©matiÃ 
©maturation 	©maturation 
©matÃ 	©matÃ 
©maÃ 	©maÃ 
©me 	©me 
©meilleure 	©meilleur
©meilleurs 	©meilleur
©membres 	©membres 
©ment 	©ment 
©mentaire 	©mentaire
©mentaires 	©mentaire
©ments 	©ments 
©menÃ 	©menÃ 
©merge 	©merg
©mergence 	©merg
©mergent 	©merg
©merger 	©merg
©mergÃ 	©merg
©mesures 	©mesures 
©met 	©met 
©mettant 	©mettant 
©mettre 	©mettre 
©micalis 	©micalis 
©micro 	©micro
©microbiologique 	©micro
©microscopiques 	©micro
©milieu 	©milieu 
©millions 	©millions 
©minaire 	©minaire 
©ministres 	©minist
©ministÃ 	©minist
©minute 	©minute 
©mique 	©mique
©miques 	©mique
©mise 	©mise 
©mises 	©mises 
©mission 	©mission
©missions 	©mission
©mixte 	©mixte 
©mobiles 	©mobil
©mobilitÃ 	©mobil
©mode 	©mode 
©moderne 	©moderne 
©module 	©module 
©modÃ 	©modÃ 
©moignages 	©moign
©moignent 	©moign
©moigner 	©moign
©moin 	©moin 
©moire 	©moire
©moires 	©moire
©moitiÃ 	©moitiÃ 
©molÃ 	©molÃ 
©mon 	©mon 
©mondial 	©mondial
©mondiale 	©mondial
©mondialement 	©mondial
©monstrateurs 	©monstrat
©monstration 	©monstration
©monstrations 	©monstration
©montpellier 	©montpellier 
©montrer 	©montrer 
©montrÃ 	©montrÃ 
©moteur 	©moteur 
©motorisation 	©motorisation 
©mots 	©mots 
©moyens 	©moyens 
©multiplication 	©multipli
©multiplier 	©multipli
©multitude 	©multi
©musÃ 	©musÃ 
©mÃ 	©mÃ 
©mÃªmes 	©mÃªmes 
©nagement 	©nagement
©nagements 	©nagement
©naissance 	©naissance 
©nantes 	©nantes 
©nat 	©nat 
©national 	©national
©nationale 	©national
©nature 	©nature
©naturelle 	©naturelle
©naturellement 	©naturelle
©nements 	©nements 
©nergie 	©nerg
©nergÃ 	©nerg
©neuf 	©neuf 
©new 	©new 
©niche 	©niche 
©nie 	©nie 
©nierie 	©nierie 
©nieur 	©nieur
©nieurs 	©nieur
©niveaux 	©niveaux 
©nom 	©nom 
©nombreuses 	©nombreuses 
©nome 	©nome 
©nomique 	©nomique 
©nomÃ 	©nomÃ 
©nord 	©nord 
©norme 	©norme 
©normÃ 	©normÃ 
©nos 	©nos 
©note 	©note 
©notoriÃ 	©notoriÃ 
©notypage 	©notyp
©notypes 	©notyp
©nous 	©nous 
©nouvel 	©nouvel 
©novembre 	©novembre 
©nuation 	©nuation 
©numÃ 	©numÃ 
©nutrition 	©nutrition
©nutritionnelle 	©nutrition
©nÃ 	©nÃ 
©o 	©o 
©objectifs 	©objectifs 
©observant 	©observ
©observation 	©observ
©observatoire 	©observ
©observe 	©observ
©observer 	©observ
©observÃ 	©observ
©obtenir 	©obten
©obtenus 	©obten
©occupante 	©occupa
©occupations 	©occupa
©octobre 	©octobre 
©ocÃ 	©ocÃ 
©odeurs 	©odeurs 
©oeuvre 	©oeuvre 
©officiel 	©officiel
©officiellement 	©officiel
©offre 	©off
©ographie 	©ographi
©ographique 	©ographique
©ographiques 	©ographique
©olfactive 	©olfactive 
©olien 	©olien 
©olive 	©olive 
©olivier 	©olivier 
©ologiques 	©ologiques 
©oms 	©oms 
©omÃ 	©omÃ 
©on 	©on 
©ophtalmologie 	©ophtalmologie 
©optimisation 	©optimis
©optimiser 	©optimis
©optiques 	©opti
©opÃ 	©opÃ 
©orbites 	©orbites 
©ordinateur 	©ordinateur 
©ores 	©ores 
©organisation 	©organis
©organisent 	©organis
©organismes 	©organis
©organisÃ 	©organis
©organoleptique 	©organ
©original 	©original 
©orique 	©orique
©oriques 	©orique
©orologie 	©orologi
©orologique 	©orologi
©osÃ 	©osÃ 
©outil 	©outil
©outils 	©outil
©outre 	©outre 
©ouverture 	©ouverture 
©ouvrage 	©ouvrage 
©ouvre 	©ouvre 
©oxygÃ 	©oxygÃ 
©page 	©page 
©palette 	©palette 
©par 	©par 
©parallÃ 	©parallÃ 
©paration 	©paration 
©paratoire 	©paratoire
©paratoires 	©paratoire
©parce 	©parce
©parcelle 	©parce
©parent 	©parent 
©parer 	©parer 
©parfait 	©parfait 
©parfois 	©parfois 
©parler 	©parler 
©parmi 	©parmi 
©part 	©part 
©partager 	©partager 
©partement 	©partement
©partements 	©partement
©partenaire 	©partena
©partenariat 	©partenariat
©partenariats 	©partenariat
©participer 	©particip
©participÃ 	©particip
©particules 	©particul
©particuliÃ 	©particul
©parties 	©parties 
©partis 	©partis 
©partition 	©partition 
©partout 	©partout 
©parÃ 	©parÃ 
©passages 	©pass
©passe 	©pass
©passent 	©pass
©passer 	©pass
©passÃ 	©pass
©pathogÃ 	©patho
©pathologie 	©patho
©patient 	©patient
©patients 	©patient
©pays 	©pays
©paysage 	©pays
©pend 	©pend 
©pendamment 	©pendamment 
©pendance 	©pendance 
©pendant 	©pendant 
©pendante 	©pendante 
©pendent 	©pendent 
©pendre 	©pendre 
©penser 	©penser 
©performance 	©performance
©performances 	©performance
©permettra 	©permettra
©permettrait 	©permettra
©personnes 	©personnes 
©persuadÃ 	©persuadÃ 
©pertinents 	©pertinents 
©perÃ 	©perÃ 
©pesant 	©pesant 
©petites 	©petit
©petits 	©petit
©ph 	©ph 
©pharmaceutiques 	©pharmaceutiques 
©phase 	©phase 
©phonie 	©phonie 
©physiciens 	©physi
©physiologie 	©physi
©physique 	©physi
©phÃ 	©phÃ 
©pierre 	©pierre 
©pilote 	©pilote
©piloter 	©pilote
©piniÃ 	©piniÃ 
©pionniers 	©pionniers 
©pisodes 	©pisodes 
©pistage 	©pistage 
©placement 	©placement
©placements 	©placement
©placent 	©placent 
©placer 	©placer 
©placÃ 	©placÃ 
©plan 	©plan 
©plans 	©plans 
©plastiques 	©plastiques 
©plateforme 	©plateforme 
©pleinement 	©pleinement 
©plore 	©plore 
©ployer 	©ployer 
©ployÃ 	©ployÃ 
©plupart 	©plupart 
©plusieurs 	©plusieurs 
©pme 	©pme 
©poids 	©poids 
©pointe 	©pointe 
©politique 	©politique 
©pologne 	©pologne 
©pond 	©pond 
©pondant 	©pondant 
©pondent 	©pondent 
©pondre 	©pondre 
©pondu 	©pondu 
©ponse 	©ponse
©ponses 	©ponse
©population 	©population
©populations 	©population
©poque 	©poque 
©porte 	©port
©porteur 	©port
©portÃ 	©port
©pose 	©pose 
©poser 	©poser 
©positionnÃ 	©positionnÃ 
©possÃ 	©possÃ 
©poste 	©poste
©postes 	©poste
©posÃ 	©posÃ 
©potentialitÃ 	©potenti
©potentiel 	©potenti
©pourquoi 	©pourquoi 
©pourra 	©pourra
©pourraient 	©pourra
©poursuit 	©poursui
©poursuivre 	©poursui
©pourtant 	©pourtant 
©pouvaient 	©pouvaient 
©pouvoir 	©pouvoir 
©pratique 	©pratique
©pratiquer 	©pratique
©premiers 	©premi
©premiÃ 	©premi
©presque 	©presque 
©prestigieux 	©prestigieux 
©principaux 	©principaux 
©printemps 	©printemps 
©prise 	©prise 
©prix 	©prix 
©problÃ 	©problÃ 
©prochables 	©procha
©prochainement 	©prochaine
©prochaines 	©prochaine
©procÃ 	©procÃ 
©production 	©production
©productions 	©production
©produite 	©produit
©produits 	©produit
©professeur 	©profess
©professionnel 	©professionnel
©professionnelle 	©professionnel
©profil 	©profil 
©programme 	©progr
©programmes 	©progr
©progresser 	©progr
©progrÃ 	©progr
©projet 	©projet 
©prolifÃ 	©prolifÃ 
©prometteur 	©prometteur 
©promouvant 	©promouvant 
©propagation 	©propagation 
©propose 	©propose 
©propre 	©propre 
©propriÃ 	©propriÃ 
©prospective 	©prospective 
©protection 	©protection 
©prothÃ 	©prothÃ 
©protocole 	©protocole 
©prototype 	©prototype 
©protÃ 	©protÃ 
©prÃ 	©prÃ 
©pspc 	©pspc 
©public 	©publi
©publication 	©publi
©publier 	©publi
©publique 	©publi
©publiÃ 	©publi
©puis 	©puis
©puisque 	©puis
©puissent 	©puis
©putÃ 	©putÃ 
©pÃ 	©pÃ 
©pÃªche 	©pÃªche 
©qu 	©qu 
©qualifiÃ 	©quali
©qualitÃ 	©quali
©quand 	©quand 
©quant 	©quant 
©quantifier 	©quantifier 
©quasiment 	©quasiment 
©quateur 	©quateur 
©quations 	©quations 
©quatre 	©quatre 
©quatriÃ 	©quatriÃ 
©quel 	©quel 
©quelle 	©quelle 
©quels 	©quels 
©quemment 	©quemment 
©quence 	©quence
©quences 	©quence
©quent 	©quent 
©quente 	©quente 
©question 	©question
©questions 	©question
©quilibre 	©quilibre 
©quinzaine 	©quinzaine 
©quipements 	©quipements 
©quiper 	©quiper 
©quipÃ 	©quipÃ 
©quivalent 	©quivalent
©quivalente 	©quivalent
©quivalents 	©quivalent
©quotidien 	©quotidien
©quotidienne 	©quotidien
©ra 	©ra 
©rabilitÃ 	©rabilitÃ 
©rable 	©rable
©rablement 	©rable
©rables 	©rable
©radar 	©radar 
©radiation 	©radiation 
©raison 	©raison 
©rait 	©rait 
©ral 	©ral 
©rale 	©rale 
©ralement 	©ralement 
©ralentissement 	©ralentissement 
©ralistes 	©ralis
©ralisÃ 	©ralis
©ramiques 	©ramiques 
©rance 	©rance 
©rant 	©rant 
©rantes 	©rantes 
©rapeutique 	©rapeutique
©rapeutiques 	©rapeutique
©rapide 	©rapide
©rapidement 	©rapide
©rapie 	©rapie 
©rappelant 	©rappel
©rappelons 	©rappel
©rapport 	©rapport 
©rat 	©rat 
©rateur 	©rateur
©rateurs 	©rateur
©ratif 	©ratif 
©ration 	©ration
©rationaliser 	©ration
©rationnel 	©ration
©rationnelle 	©ration
©rationnelles 	©ration
©rationnels 	©ration
©rations 	©ration
©rative 	©rative
©rativement 	©rative
©ratives 	©rative
©ratoire 	©ratoire
©ratoires 	©ratoire
©rature 	©rature
©ratures 	©rature
©raux 	©raux 
©recevoir 	©recevoir 
©rechercher 	©recherch
©recherchÃ 	©recherch
©reconnaÃ 	©reconn
©reconnu 	©reconn
©recÃ 	©recÃ 
©regroupe 	©regroupe 
©rejoindre 	©rejoindre 
©relations 	©relations 
©relever 	©relever 
©remettre 	©remettre 
©remis 	©remis 
©remplacer 	©remplacer 
©rence 	©rence 
©rences 	©rences 
©renciation 	©renciation 
©rencontrer 	©rencontrer 
©rendez 	©rendez 
©rendu 	©rendu 
©rendue 	©rendue 
©rennitÃ 	©rennitÃ 
©rent 	©rent 
©rente 	©rente 
©rentes 	©rentes 
©rents 	©rents 
©reprÃ 	©reprÃ 
©rer 	©rer 
©respect 	©respect 
©responsabilitÃ 	©responsab
©responsable 	©responsab
©ressait 	©ressait 
©ressant 	©ressant
©ressante 	©ressant
©ressantes 	©ressant
©ressants 	©ressant
©resse 	©resse 
©ressent 	©ressent 
©resser 	©resser 
©ressera 	©ressera 
©ressources 	©ressources 
©ressÃ 	©ressÃ 
©restait 	©restait 
©restaurer 	©restaurer 
©reste 	©reste 
©rester 	©rester 
©retard 	©retard 
©retd 	©retd 
©retour 	©retour 
©retrouve 	©retrouve 
©reuses 	©reuses 
©revanche 	©revanche 
©riaux 	©riaux 
©ricain 	©ricain
©ricaines 	©ricain
©ricains 	©ricain
©riche 	©riche 
©rie 	©rie 
©riel 	©riel 
©riels 	©riels 
©rien 	©rien 
©rience 	©rience
©riences 	©rience
©rienne 	©rienne
©riennes 	©rienne
©ries 	©ries 
©rieur 	©rieur 
©rieure 	©rieure 
©rieures 	©rieures 
©rieux 	©rieux 
©rification 	©rifi
©rifier 	©rifi
©rimental 	©riment
©rimentale 	©riment
©rimentales 	©riment
©rimentation 	©rimentation
©rimentations 	©rimentation
©rimenter 	©riment
©rimÃ 	©rimÃ 
©rinaire 	©rinaire 
©riode 	©riode 
©riot 	©riot 
©riphÃ 	©riphÃ 
©rique 	©rique
©riques 	©rique
©rir 	©rir 
©risation 	©risation 
©rise 	©rise 
©riser 	©riser 
©risques 	©risques 
©ristique 	©ristique
©ristiques 	©ristique
©risÃ 	©risÃ 
©ritable 	©ritable
©ritablement 	©ritable
©ritables 	©ritable
©rite 	©rite 
©rivÃ 	©rivÃ 
©ro 	©ro 
©robert 	©robert 
©rologie 	©rologie 
©romain 	©romain 
©ronautique 	©ronautique 
©rose 	©rose 
©rospatial 	©rospatial 
©rouges 	©rouges 
©roulant 	©roulant 
©roule 	©roule 
©roulement 	©roulement 
©rouler 	©rouler 
©roulera 	©roulera 
©roulÃ 	©roulÃ 
©rupture 	©rupture 
©rus 	©rus 
©rÃ 	©rÃ 
©rÃªt 	©rÃªt
©rÃªts 	©rÃªt
©s 	©s 
©saffection 	©saffection 
©saint 	©saint 
©salinitÃ 	©salinitÃ 
©salon 	©salon 
©sanitaire 	©sanitaire 
©santÃ 	©santÃ 
©satisfaire 	©satisfaire 
©sauter 	©sauter 
©saveur 	©saveur 
©savoir 	©savoir 
©science 	©science
©sciences 	©science
©scientifique 	©scien
©seau 	©seau
©seaux 	©seau
©second 	©second 
©segment 	©segment 
©selon 	©selon 
©semble 	©semble 
©sence 	©sence 
©seniors 	©seniors 
©sens 	©sens 
©sensible 	©sensible 
©sentant 	©sentant
©sentants 	©sentant
©sentation 	©sentation
©sentations 	©sentation
©sente 	©sente 
©sentent 	©sentent 
©senter 	©senter 
©sentera 	©sentera 
©senteront 	©senteront 
©sentes 	©sentes 
©sents 	©sents 
©sentÃ 	©sentÃ 
©septembre 	©septembre 
©serait 	©serait 
©seront 	©seront 
©servant 	©servant 
©servation 	©servation 
©serve 	©serve 
©server 	©server 
©service 	©service
©services 	©service
©servÃ 	©servÃ 
©seul 	©seul 
©side 	©side 
©sidence 	©sidence 
©sident 	©sident 
©sidente 	©sidente 
©sidents 	©sidents 
©sidus 	©sidus 
©sidÃ 	©sidÃ 
©signe 	©sign
©significatifs 	©significati
©significative 	©significati
©signifie 	©signifi
©simple 	©simple 
©simuler 	©simuler 
©sinon 	©sinon 
©sion 	©sion
©sions 	©sion
©sir 	©sir 
©sistance 	©sistan
©sistant 	©sistan
©sistantes 	©sistan
©sistants 	©sistan
©sister 	©sist
©site 	©site 
©sitent 	©sitent 
©sites 	©sites 
©situation 	©situation
©situations 	©situation
©situe 	©situe 
©sitÃ 	©sitÃ 
©siÃ 	©siÃ 
©sociale 	©sociale
©sociales 	©sociale
©sociÃ 	©soci
©soient 	©soient 
©sol 	©sol 
©solaire 	©solaire
©solaires 	©solaire
©solide 	©solide 
©solution 	©solution
©solutions 	©solution
©son 	©son 
©sonance 	©sonance 
©sormais 	©sormais 
©souci 	©souci 
©soudainement 	©soudainement 
©soudre 	©soudre 
©souffrant 	©souffrant 
©souhait 	©souhait
©souhaitent 	©souhait
©souligner 	©soulign
©soulignÃ 	©soulign
©souplesse 	©souplesse 
©soutenu 	©soutenu 
©souvient 	©souvient 
©spatial 	©spatial 
©spontanÃ 	©spontanÃ 
©spÃ 	©spÃ 
©stand 	©stand 
©start 	©start 
©stockage 	©stock
©stocker 	©stock
©stratÃ 	©stratÃ 
©structures 	©structures 
©sub 	©sub 
©successivement 	©succ
©succÃ 	©succ
©sud 	©sud 
©suite 	©suite 
©sujet 	©sujet 
©sultant 	©sulta
©sultat 	©sulta
©sument 	©sume
©sumer 	©sume
©superficie 	©superficie 
©supÃ 	©supÃ 
©surface 	©surface 
©surprenant 	©surprenant 
©surveillance 	©surveill
©surveiller 	©surveill
©survie 	©survie 
©susciter 	©susciter 
©symboliquement 	©symboliquement 
©synthÃ 	©synthÃ 
©systÃ 	©systÃ 
©sÃ 	©sÃ 
©tabli 	©tabli
©tablie 	©tabli
©tablir 	©tabli
©tablissant 	©tabli
©tablissement 	©tabli
©tablissements 	©tabli
©tablissent 	©tabli
©tabolique 	©tabolique
©taboliques 	©tabolique
©tabolisme 	©taboli
©tagÃ 	©tagÃ 
©taient 	©taient 
©tail 	©tail 
©taille 	©taille 
©tails 	©tails 
©taire 	©taire
©taires 	©taire
©tait 	©tait 
©tal 	©tal 
©tale 	©tale 
©tales 	©tales 
©talliques 	©talliques 
©tanchÃ 	©tanchÃ 
©tape 	©tape
©tapes 	©tape
©tard 	©tard 
©tat 	©tat 
©tats 	©tats 
©taux 	©taux 
©techniciens 	©techn
©technologie 	©technologi
©technologies 	©technologi
©technologique 	©technologi
©tecter 	©tecter 
©tecteur 	©tecteur 
©tection 	©tection 
©tectÃ 	©tectÃ 
©teil 	©teil 
©tel 	©tel 
©telle 	©telle 
©tels 	©tels 
©tempÃ 	©tempÃ 
©tences 	©tences 
©tendant 	©tendant 
©tendre 	©tendre 
©tendu 	©tendu 
©tendue 	©tendue 
©tendues 	©tendues 
©tenu 	©tenu 
©ter 	©ter 
©tergents 	©tergents 
©termes 	©termes 
©terminant 	©termin
©terminent 	©termin
©terminer 	©termin
©territoire 	©territoire
©territoires 	©territoire
©territoriale 	©territo
©thanisation 	©than
©thanol 	©than
©thode 	©thod
©thodes 	©thod
©thodologie 	©thodologie
©thodologies 	©thodologie
©thÃ 	©thÃ 
©tient 	©tient 
©tier 	©tier 
©tiers 	©tiers 
©tions 	©tions 
©tique 	©tique
©tiquement 	©tique
©tiques 	©tique
©tiser 	©tiser 
©tisÃ 	©tisÃ 
©titane 	©titane 
©tition 	©tition 
©titivitÃ 	©titivitÃ 
©toile 	©toile
©toiles 	©toile
©tonnant 	©tonnant
©tonnante 	©tonnant
©tonnantes 	©tonnant
©tonne 	©tonn
©tonnement 	©tonn
©totale 	©totale
©totalement 	©totale
©toulousaine 	©toulous
©toulouse 	©toulous
©tour 	©tour 
©tous 	©tous 
©toute 	©toute 
©traduit 	©traduit 
©traitement 	©trait
©traitÃ 	©trait
©tranger 	©tranger
©trangers 	©tranger
©trangÃ 	©trangÃ 
©transfert 	©transfert 
©transfÃ 	©transfÃ 
©transition 	©transition 
©transmission 	©transmission 
©transport 	©transport
©transporter 	©transport
©transports 	©transport
©tration 	©tration 
©travaillant 	©travaill
©travaille 	©travaill
©travaillent 	©travaill
©travailler 	©travaill
©travers 	©travers 
©trentaine 	©trentaine 
©trie 	©trie 
©trique 	©trique 
©trochimie 	©trochimie 
©trois 	©trois 
©troisiÃ 	©troisiÃ 
©troit 	©troit 
©troite 	©troite 
©troits 	©troits 
©trologie 	©trologie 
©trop 	©trop 
©trospectives 	©trospectives 
©trou 	©trou 
©trouve 	©trouve
©trouver 	©trouve
©truire 	©truire 
©tude 	©tude 
©tudes 	©tudes 
©tudiant 	©tudiant
©tudiantes 	©tudiant
©tudiants 	©tudiant
©tudie 	©tudie 
©tudier 	©tudier 
©tudiÃ 	©tudiÃ 
©tungsten 	©tungsten 
©tutelle 	©tutelle 
©types 	©types 
©tÃ 	©tÃ 
©tÃªtes 	©tÃªtes 
©uni 	©uni 
©union 	©union 
©uniquement 	©uniquement 
©unir 	©unir 
©unira 	©unira 
©uniront 	©uniront 
©unis 	©unis 
©unissant 	©unissant 
©unitÃ 	©unitÃ 
©universitaire 	©universitaire
©universitaires 	©universitaire
©universitÃ 	©universit
©uns 	©uns 
©urbaine 	©urbaine 
©usage 	©usage
©usages 	©usage
©ussi 	©ussi
©ussir 	©ussi
©ussissent 	©ussi
©ussit 	©ussi
©ussite 	©ussi
©utilisent 	©utili
©utiliser 	©utili
©utilisÃ 	©utili
©utilitÃ 	©utili
©vacuation 	©vacuation 
©valence 	©valence 
©validation 	©valid
©valider 	©valid
©validÃ 	©valid
©vallÃ 	©vallÃ 
©valorisÃ 	©valorisÃ 
©valuation 	©valuation
©valuations 	©valuation
©valuer 	©valuer 
©valuÃ 	©valuÃ 
©variabilitÃ 	©variabilitÃ 
©vation 	©vation 
©veloppant 	©velopp
©veloppement 	©velopp
©veloppements 	©velopp
©veloppent 	©velopp
©veloppera 	©velopp
©veloppeurs 	©velopp
©veloppÃ 	©velopp
©venir 	©venir 
©ventail 	©ventail 
©ventifs 	©ventifs 
©vention 	©vention 
©ventives 	©ventives 
©ventuellement 	©ventuel
©ventuels 	©ventuel
©venus 	©venus 
©verres 	©verres 
©vers 	©vers 
©versible 	©versible 
©version 	©version 
©veux 	©veux 
©via 	©via 
©vice 	©vice 
©victimes 	©victimes 
©videmment 	©vide
©vidence 	©vide
©vieillissement 	©vieillissement 
©vient 	©vient 
©ville 	©ville 
©vingtaine 	©vingtaine 
©vise 	©vise 
©vision 	©vision 
©visiteurs 	©visiteurs 
©visualiser 	©visualiser 
©vitable 	©vitable
©vitables 	©vitable
©vitagora 	©vitagora 
©vitant 	©vitant 
©vite 	©vite 
©viter 	©viter 
©vitÃ 	©vitÃ 
©vocation 	©vocation 
©voie 	©voie 
©voient 	©voient 
©voies 	©voies 
©voir 	©voir 
©voit 	©voit 
©volontairement 	©volontairement 
©volue 	©volue 
©voluer 	©voluer 
©volution 	©volution
©volutionner 	©volution
©voluÃ 	©voluÃ 
©voquant 	©voqu
©voque 	©voqu
©voquer 	©voqu
©voquÃ 	©voqu
©vraiment 	©vraiment 
©vrier 	©vrier 
©vu 	©vu 
©vue 	©vue 
©vues 	©vues 
©vulnÃ 	©vulnÃ 
©vÃ 	©vÃ 
©yvette 	©yvette 
©Ã 	©Ã 
®le 	®le 
®nant 	®nant 
®ne 	®ne 
®nent 	®nent 
®ner 	®ner 
®nes 	®nes 
®nÃ 	®nÃ 
®t 	®t 
®te 	®te 
®tre 	®tre 
®trise 	®tris
®trisent 	®tris
®triser 	®tris
®trisÃ 	®tris
¯de 	¯de 
´le 	´le 
´ler 	´ler 
´les 	´les 
´lÃ 	´lÃ 
´me 	´me 
´mÃ 	´mÃ 
´ne 	´ne 
´nes 	´nes 
´pitaux 	´pitaux 
´t 	´t 
´te 	´te 
´tel 	´tel 
´tes 	´tes 
´tre 	´tre 
´ts 	´ts 
´turera 	´turera 
´tÃ 	´tÃ 
Ã 	Ã 
